,dong,quarter,pop_total,pop_male,pop_female
0,강남구 개포1동,20221,20525,9966,10559
1,강남구 개포1동,20222,20970,10197,10773
2,강남구 개포1동,20223,20920,10164,10756
3,강남구 개포1동,20224,20699,10023,10676
4,강남구 개포1동,20231,20697,9991,10706
5,강남구 개포1동,20232,20645,9952,10693
6,강남구 개포1동,20233,20659,9960,10699
7,강남구 개포1동,20234,25885,12501,13384
8,강남구 개포1동,20241,61944,29980,31964
9,강남구 개포1동,20242,74199,35862,38337
10,강남구 개포2동,20221,84374,40952,43422
11,강남구 개포2동,20222,84327,40919,43408
12,강남구 개포2동,20223,84676,41123,43553
13,강남구 개포2동,20224,85767,41639,44128
14,강남구 개포2동,20231,93643,45400,48243
15,강남구 개포2동,20232,112601,54529,58072
16,강남구 개포2동,20233,120928,58511,62417
17,강남구 개포2동,20234,124519,60216,64303
18,강남구 개포2동,20241,125149,60597,64552
19,강남구 개포2동,20242,125433,60742,64691
20,강남구 개포3동,20221,52571,25443,27128
21,강남구 개포3동,20222,52495,25391,27104
22,강남구 개포3동,20223,52415,25346,27069
23,강남구 개포3동,20224,34757,16814,17943
24,강남구 개포3동,20231,51737,25034,26703
25,강남구 개포3동,20232,51275,24838,26437
26,강남구 개포3동,20233,50911,24665,26246
27,강남구 개포3동,20234,50620,24536,26084
28,강남구 개포3동,20241,50331,24379,25952
29,강남구 개포3동,20242,50203,24260,25943
30,강남구 개포4동,20221,71043,34378,36665
31,강남구 개포4동,20222,70780,34214,36566
32,강남구 개포4동,20223,70851,34222,36629
33,강남구 개포4동,20224,70571,34037,36534
34,강남구 개포4동,20231,70345,33881,36464
35,강남구 개포4동,20232,70310,33863,36447
36,강남구 개포4동,20233,70179,33790,36389
37,강남구 개포4동,20234,69978,33680,36298
38,강남구 개포4동,20241,69423,33398,36025
39,강남구 개포4동,20242,69224,33278,35946
40,강남구 논현1동,20221,66046,31071,34975
41,강남구 논현1동,20222,65972,31072,34900
42,강남구 논현1동,20223,65397,30729,34668
43,강남구 논현1동,20224,64497,30401,34096
44,강남구 논현1동,20231,64099,30274,33825
45,강남구 논현1동,20232,63932,30154,33778
46,강남구 논현1동,20233,63464,29884,33580
47,강남구 논현1동,20234,63269,29824,33445
48,강남구 논현1동,20241,62921,29674,33247
49,강남구 논현1동,20242,62620,29650,32970
50,강남구 논현2동,20221,62972,29447,33525
51,강남구 논현2동,20222,62676,29291,33385
52,강남구 논현2동,20223,62084,29021,33063
53,강남구 논현2동,20224,61579,28838,32741
54,강남구 논현2동,20231,61473,28710,32763
55,강남구 논현2동,20232,61976,28811,33165
56,강남구 논현2동,20233,61665,28642,33023
57,강남구 논현2동,20234,61211,28374,32837
58,강남구 논현2동,20241,61071,28249,32822
59,강남구 논현2동,20242,60904,28213,32691
60,강남구 대치1동,20221,72046,36158,35888
61,강남구 대치1동,20222,71803,36018,35785
62,강남구 대치1동,20223,71701,35961,35740
63,강남구 대치1동,20224,71555,35900,35655
64,강남구 대치1동,20231,71495,35877,35618
65,강남구 대치1동,20232,71284,35750,35534
66,강남구 대치1동,20233,71760,35977,35783
67,강남구 대치1동,20234,71820,35980,35840
68,강남구 대치1동,20241,71534,35818,35716
69,강남구 대치1동,20242,71287,35694,35593
70,강남구 대치2동,20221,110161,55748,54413
71,강남구 대치2동,20222,110155,55669,54486
72,강남구 대치2동,20223,110929,56054,54875
73,강남구 대치2동,20224,111093,56117,54976
74,강남구 대치2동,20231,110741,56004,54737
75,강남구 대치2동,20232,110664,55957,54707
76,강남구 대치2동,20233,113417,57443,55974
77,강남구 대치2동,20234,114906,58297,56609
78,강남구 대치2동,20241,114563,58201,56362
79,강남구 대치2동,20242,114355,58104,56251
80,강남구 대치4동,20221,59048,27939,31109
81,강남구 대치4동,20222,58532,27746,30786
82,강남구 대치4동,20223,58388,27731,30657
83,강남구 대치4동,20224,57867,27489,30378
84,강남구 대치4동,20231,57075,27147,29928
85,강남구 대치4동,20232,56603,26891,29712
86,강남구 대치4동,20233,56711,27059,29652
87,강남구 대치4동,20234,56296,26853,29443
88,강남구 대치4동,20241,55389,26429,28960
89,강남구 대치4동,20242,55235,26453,28782
90,강남구 도곡1동,20221,64254,30429,33825
91,강남구 도곡1동,20222,64164,30428,33736
92,강남구 도곡1동,20223,63844,30274,33570
93,강남구 도곡1동,20224,63552,30072,33480
94,강남구 도곡1동,20231,62504,29640,32864
95,강남구 도곡1동,20232,62129,29514,32615
96,강남구 도곡1동,20233,62102,29457,32645
97,강남구 도곡1동,20234,61798,29304,32494
98,강남구 도곡1동,20241,61546,29157,32389
99,강남구 도곡1동,20242,61522,29154,32368
100,강남구 도곡2동,20221,99330,46177,53153
101,강남구 도곡2동,20222,98933,45997,52936
102,강남구 도곡2동,20223,98536,45796,52740
103,강남구 도곡2동,20224,98348,45665,52683
104,강남구 도곡2동,20231,98174,45566,52608
105,강남구 도곡2동,20232,97759,45377,52382
106,강남구 도곡2동,20233,97851,45367,52484
107,강남구 도곡2동,20234,98060,45461,52599
108,강남구 도곡2동,20241,97424,45181,52243
109,강남구 도곡2동,20242,96964,45041,51923
110,강남구 삼성1동,20221,38513,18942,19571
111,강남구 삼성1동,20222,38244,18747,19497
112,강남구 삼성1동,20223,38048,18691,19357
113,강남구 삼성1동,20224,37580,18461,19119
114,강남구 삼성1동,20231,37382,18318,19064
115,강남구 삼성1동,20232,37139,18168,18971
116,강남구 삼성1동,20233,37027,18108,18919
117,강남구 삼성1동,20234,36671,17945,18726
118,강남구 삼성1동,20241,36278,17803,18475
119,강남구 삼성1동,20242,35995,17644,18351
120,강남구 삼성2동,20221,92296,44201,48095
121,강남구 삼성2동,20222,92772,44442,48330
122,강남구 삼성2동,20223,92642,44423,48219
123,강남구 삼성2동,20224,92446,44382,48064
124,강남구 삼성2동,20231,92275,44309,47966
125,강남구 삼성2동,20232,91629,43949,47680
126,강남구 삼성2동,20233,91415,43842,47573
127,강남구 삼성2동,20234,91917,44124,47793
128,강남구 삼성2동,20241,91509,43863,47646
129,강남구 삼성2동,20242,91344,43795,47549
130,강남구 세곡동,20221,129365,61025,68340
131,강남구 세곡동,20222,129400,60994,68406
132,강남구 세곡동,20223,129726,61172,68554
133,강남구 세곡동,20224,129799,61219,68580
134,강남구 세곡동,20231,130203,61237,68966
135,강남구 세곡동,20232,132148,61947,70201
136,강남구 세곡동,20233,136106,63850,72256
137,강남구 세곡동,20234,136742,64067,72675
138,강남구 세곡동,20241,136077,63727,72350
139,강남구 세곡동,20242,137394,64233,73161
140,강남구 수서동,20221,44147,19992,24155
141,강남구 수서동,20222,43734,19824,23910
142,강남구 수서동,20223,43573,19744,23829
143,강남구 수서동,20224,43137,19517,23620
144,강남구 수서동,20231,42800,19306,23494
145,강남구 수서동,20232,42570,19203,23367
146,강남구 수서동,20233,42520,19192,23328
147,강남구 수서동,20234,42241,19022,23219
148,강남구 수서동,20241,41901,18847,23054
149,강남구 수서동,20242,41645,18670,22975
150,강남구 신사동,20221,47805,22150,25655
151,강남구 신사동,20222,47339,21918,25421
152,강남구 신사동,20223,47323,21976,25347
153,강남구 신사동,20224,46981,21832,25149
154,강남구 신사동,20231,46743,21720,25023
155,강남구 신사동,20232,46673,21728,24945
156,강남구 신사동,20233,46397,21597,24800
157,강남구 신사동,20234,46311,21633,24678
158,강남구 신사동,20241,46257,21599,24658
159,강남구 신사동,20242,46164,21545,24619
160,강남구 압구정동,20221,78655,36394,42261
161,강남구 압구정동,20222,78247,36212,42035
162,강남구 압구정동,20223,77837,35961,41876
163,강남구 압구정동,20224,77277,35672,41605
164,강남구 압구정동,20231,77134,35652,41482
165,강남구 압구정동,20232,76859,35581,41278
166,강남구 압구정동,20233,76796,35512,41284
167,강남구 압구정동,20234,76779,35513,41266
168,강남구 압구정동,20241,76748,35556,41192
169,강남구 압구정동,20242,76592,35487,41105
170,강남구 역삼1동,20221,106381,51796,54585
171,강남구 역삼1동,20222,105658,51363,54295
172,강남구 역삼1동,20223,104885,50972,53913
173,강남구 역삼1동,20224,103743,50505,53238
174,강남구 역삼1동,20231,103263,50309,52954
175,강남구 역삼1동,20232,102885,50115,52770
176,강남구 역삼1동,20233,102996,50289,52707
177,강남구 역삼1동,20234,102651,50122,52529
178,강남구 역삼1동,20241,102439,50070,52369
179,강남구 역삼1동,20242,102599,50205,52394
180,강남구 역삼2동,20221,107959,50596,57363
181,강남구 역삼2동,20222,108643,50865,57778
182,강남구 역삼2동,20223,110755,51859,58896
183,강남구 역삼2동,20224,110931,51915,59016
184,강남구 역삼2동,20231,111041,51968,59073
185,강남구 역삼2동,20232,110729,51714,59015
186,강남구 역삼2동,20233,110550,51511,59039
187,강남구 역삼2동,20234,109484,51054,58430
188,강남구 역삼2동,20241,108980,50798,58182
189,강남구 역삼2동,20242,108822,50697,58125
190,강남구 일원1동,20221,45219,22114,23105
191,강남구 일원1동,20222,45026,21936,23090
192,강남구 일원1동,20223,44850,21813,23037
193,강남구 일원1동,20224,44593,21661,22932
194,강남구 일원1동,20231,44431,21560,22871
195,강남구 일원1동,20232,44003,21323,22680
196,강남구 일원1동,20233,43922,21286,22636
197,강남구 일원1동,20234,43803,21220,22583
198,강남구 일원1동,20241,43486,21076,22410
199,강남구 일원1동,20242,43071,20797,22274
200,강남구 일원본동,20221,69552,34375,35177
201,강남구 일원본동,20222,69308,34275,35033
202,강남구 일원본동,20223,69273,34290,34983
203,강남구 일원본동,20224,68938,34148,34790
204,강남구 일원본동,20231,68809,34065,34744
205,강남구 일원본동,20232,68491,33878,34613
206,강남구 일원본동,20233,68531,33858,34673
207,강남구 일원본동,20234,68545,33806,34739
208,강남구 일원본동,20241,68176,33581,34595
209,강남구 일원본동,20242,67998,33491,34507
210,강남구 청담동,20221,76774,35839,40935
211,강남구 청담동,20222,76392,35679,40713
212,강남구 청담동,20223,76148,35534,40614
213,강남구 청담동,20224,75718,35415,40303
214,강남구 청담동,20231,75595,35318,40277
215,강남구 청담동,20232,75225,35227,39998
216,강남구 청담동,20233,74652,34951,39701
217,강남구 청담동,20234,74062,34585,39477
218,강남구 청담동,20241,73843,34412,39431
219,강남구 청담동,20242,73583,34240,39343
220,강동구 강일동,20221,98447,47293,51154
221,강동구 강일동,20222,98720,47384,51336
222,강동구 강일동,20223,98946,47506,51440
223,강동구 강일동,20224,98645,47362,51283
224,강동구 강일동,20231,98663,47382,51281
225,강동구 강일동,20232,98504,47133,51371
226,강동구 강일동,20233,98024,46829,51195
227,강동구 강일동,20234,100173,47894,52279
228,강동구 강일동,20241,103509,49560,53949
229,강동구 강일동,20242,103754,49717,54037
230,강동구 고덕1동,20221,72220,36719,35501
231,강동구 고덕1동,20222,71517,36355,35162
232,강동구 고덕1동,20223,71461,36307,35154
233,강동구 고덕1동,20224,71385,36243,35142
234,강동구 고덕1동,20231,71485,36334,35151
235,강동구 고덕1동,20232,71583,36437,35146
236,강동구 고덕1동,20233,71759,36534,35225
237,강동구 고덕1동,20234,71915,36604,35311
238,강동구 고덕1동,20241,71733,36561,35172
239,강동구 고덕1동,20242,71566,36496,35070
240,강동구 고덕2동,20221,67052,33759,33293
241,강동구 고덕2동,20222,67286,33893,33393
242,강동구 고덕2동,20223,67534,33981,33553
243,강동구 고덕2동,20224,67637,34057,33580
244,강동구 고덕2동,20231,68099,34351,33748
245,강동구 고덕2동,20232,68155,34331,33824
246,강동구 고덕2동,20233,68312,34363,33949
247,강동구 고덕2동,20234,68416,34398,34018
248,강동구 고덕2동,20241,70901,35664,35237
249,강동구 고덕2동,20242,74161,37254,36907
250,강동구 길동,20221,136761,66834,69927
251,강동구 길동,20222,136147,66555,69592
252,강동구 길동,20223,135697,66294,69403
253,강동구 길동,20224,135186,65938,69248
254,강동구 길동,20231,134791,65753,69038
255,강동구 길동,20232,134406,65525,68881
256,강동구 길동,20233,134088,65324,68764
257,강동구 길동,20234,133970,65251,68719
258,강동구 길동,20241,134005,65242,68763
259,강동구 길동,20242,134174,65264,68910
260,강동구 둔촌1동,20221,397,223,174
261,강동구 둔촌1동,20222,396,222,174
262,강동구 둔촌1동,20223,333,188,145
263,강동구 둔촌1동,20224,202,112,90
264,강동구 둔촌1동,20231,193,106,87
265,강동구 둔촌1동,20232,189,103,86
266,강동구 둔촌1동,20233,184,100,84
267,강동구 둔촌1동,20234,156,87,69
268,강동구 둔촌1동,20241,156,87,69
269,강동구 둔촌1동,20242,153,84,69
270,강동구 둔촌2동,20221,73741,36332,37409
271,강동구 둔촌2동,20222,73329,36059,37270
272,강동구 둔촌2동,20223,72940,35837,37103
273,강동구 둔촌2동,20224,72596,35644,36952
274,강동구 둔촌2동,20231,72407,35559,36848
275,강동구 둔촌2동,20232,72187,35492,36695
276,강동구 둔촌2동,20233,72598,35658,36940
277,강동구 둔촌2동,20234,72875,35691,37184
278,강동구 둔촌2동,20241,72834,35673,37161
279,강동구 둔촌2동,20242,72357,35427,36930
280,강동구 명일1동,20221,77492,37728,39764
281,강동구 명일1동,20222,77184,37543,39641
282,강동구 명일1동,20223,76989,37429,39560
283,강동구 명일1동,20224,76737,37378,39359
284,강동구 명일1동,20231,76470,37244,39226
285,강동구 명일1동,20232,76445,37287,39158
286,강동구 명일1동,20233,76074,37146,38928
287,강동구 명일1동,20234,75876,37100,38776
288,강동구 명일1동,20241,75530,36896,38634
289,강동구 명일1동,20242,75331,36758,38573
290,강동구 명일2동,20221,52523,25750,26773
291,강동구 명일2동,20222,52227,25511,26716
292,강동구 명일2동,20223,52052,25445,26607
293,강동구 명일2동,20224,51842,25319,26523
294,강동구 명일2동,20231,51760,25233,26527
295,강동구 명일2동,20232,51645,25135,26510
296,강동구 명일2동,20233,51615,25124,26491
297,강동구 명일2동,20234,51311,25005,26306
298,강동구 명일2동,20241,50979,24823,26156
299,강동구 명일2동,20242,50547,24615,25932
300,강동구 상일1동,20221,116200,57312,58888
301,강동구 상일1동,20222,116568,57424,59144
302,강동구 상일1동,20223,116787,57480,59307
303,강동구 상일1동,20224,116990,57569,59421
304,강동구 상일1동,20231,117692,57859,59833
305,강동구 상일1동,20232,117866,57912,59954
306,강동구 상일1동,20233,117966,57954,60012
307,강동구 상일1동,20234,117916,57974,59942
308,강동구 상일1동,20241,117756,57860,59896
309,강동구 상일1동,20242,117626,57800,59826
310,강동구 상일2동,20221,30574,14362,16212
311,강동구 상일2동,20222,33710,15816,17894
312,강동구 상일2동,20223,35687,16666,19021
313,강동구 상일2동,20224,35673,16666,19007
314,강동구 상일2동,20231,35813,16692,19121
315,강동구 상일2동,20232,35781,16666,19115
316,강동구 상일2동,20233,35593,16557,19036
317,강동구 상일2동,20234,35269,16392,18877
318,강동구 상일2동,20241,36767,17091,19676
319,강동구 상일2동,20242,40575,18964,21611
320,강동구 성내1동,20221,59834,28813,31021
321,강동구 성내1동,20222,59729,28712,31017
322,강동구 성내1동,20223,59611,28614,30997
323,강동구 성내1동,20224,59278,28470,30808
324,강동구 성내1동,20231,58957,28334,30623
325,강동구 성내1동,20232,58806,28187,30619
326,강동구 성내1동,20233,58588,28073,30515
327,강동구 성내1동,20234,58271,27892,30379
328,강동구 성내1동,20241,57957,27731,30226
329,강동구 성내1동,20242,57859,27720,30139
330,강동구 성내2동,20221,70287,34630,35657
331,강동구 성내2동,20222,69750,34341,35409
332,강동구 성내2동,20223,69520,34199,35321
333,강동구 성내2동,20224,69238,34031,35207
334,강동구 성내2동,20231,68777,33830,34947
335,강동구 성내2동,20232,68343,33670,34673
336,강동구 성내2동,20233,68544,33676,34868
337,강동구 성내2동,20234,70249,34255,35994
338,강동구 성내2동,20241,70685,34396,36289
339,강동구 성내2동,20242,71611,34866,36745
340,강동구 성내3동,20221,69043,33858,35185
341,강동구 성내3동,20222,68830,33653,35177
342,강동구 성내3동,20223,68849,33699,35150
343,강동구 성내3동,20224,68425,33463,34962
344,강동구 성내3동,20231,68242,33394,34848
345,강동구 성내3동,20232,67762,33158,34604
346,강동구 성내3동,20233,67470,32961,34509
347,강동구 성내3동,20234,67363,32891,34472
348,강동구 성내3동,20241,67153,32775,34378
349,강동구 성내3동,20242,66688,32541,34147
350,강동구 암사1동,20221,103276,51229,52047
351,강동구 암사1동,20222,102802,50939,51863
352,강동구 암사1동,20223,102386,50755,51631
353,강동구 암사1동,20224,102032,50492,51540
354,강동구 암사1동,20231,102079,50505,51574
355,강동구 암사1동,20232,102080,50448,51632
356,강동구 암사1동,20233,101827,50281,51546
357,강동구 암사1동,20234,101294,50105,51189
358,강동구 암사1동,20241,101123,50033,51090
359,강동구 암사1동,20242,100755,49851,50904
360,강동구 암사2동,20221,45462,22016,23446
361,강동구 암사2동,20222,45380,21951,23429
362,강동구 암사2동,20223,45284,21919,23365
363,강동구 암사2동,20224,45101,21823,23278
364,강동구 암사2동,20231,44878,21703,23175
365,강동구 암사2동,20232,44775,21627,23148
366,강동구 암사2동,20233,44711,21568,23143
367,강동구 암사2동,20234,44616,21516,23100
368,강동구 암사2동,20241,44289,21333,22956
369,강동구 암사2동,20242,44168,21233,22935
370,강동구 암사3동,20221,53520,26207,27313
371,강동구 암사3동,20222,52933,25920,27013
372,강동구 암사3동,20223,52468,25689,26779
373,강동구 암사3동,20224,52265,25549,26716
374,강동구 암사3동,20231,52388,25608,26780
375,강동구 암사3동,20232,52243,25537,26706
376,강동구 암사3동,20233,52035,25472,26563
377,강동구 암사3동,20234,51664,25336,26328
378,강동구 암사3동,20241,51574,25273,26301
379,강동구 암사3동,20242,51540,25246,26294
380,강동구 천호1동,20221,80133,39358,40775
381,강동구 천호1동,20222,79827,39179,40648
382,강동구 천호1동,20223,79797,39181,40616
383,강동구 천호1동,20224,79384,38982,40402
384,강동구 천호1동,20231,79209,38953,40256
385,강동구 천호1동,20232,78771,38750,40021
386,강동구 천호1동,20233,78462,38574,39888
387,강동구 천호1동,20234,78099,38393,39706
388,강동구 천호1동,20241,77771,38170,39601
389,강동구 천호1동,20242,77403,37850,39553
390,강동구 천호2동,20221,99337,48655,50682
391,강동구 천호2동,20222,98946,48470,50476
392,강동구 천호2동,20223,99416,48681,50735
393,강동구 천호2동,20224,99620,48712,50908
394,강동구 천호2동,20231,99701,48738,50963
395,강동구 천호2동,20232,99492,48635,50857
396,강동구 천호2동,20233,98962,48350,50612
397,강동구 천호2동,20234,98548,48079,50469
398,강동구 천호2동,20241,98129,47768,50361
399,강동구 천호2동,20242,97798,47500,50298
400,강동구 천호3동,20221,79425,38622,40803
401,강동구 천호3동,20222,78994,38350,40644
402,강동구 천호3동,20223,78743,38152,40591
403,강동구 천호3동,20224,78502,37957,40545
404,강동구 천호3동,20231,78799,38074,40725
405,강동구 천호3동,20232,78762,38047,40715
406,강동구 천호3동,20233,78587,37928,40659
407,강동구 천호3동,20234,78302,37730,40572
408,강동구 천호3동,20241,78420,37775,40645
409,강동구 천호3동,20242,78720,37866,40854
410,강북구 미아동,20221,64305,30894,33411
411,강북구 미아동,20222,64049,30727,33322
412,강북구 미아동,20223,63901,30693,33208
413,강북구 미아동,20224,63504,30509,32995
414,강북구 미아동,20231,63400,30417,32983
415,강북구 미아동,20232,63243,30284,32959
416,강북구 미아동,20233,63027,30183,32844
417,강북구 미아동,20234,62682,30010,32672
418,강북구 미아동,20241,62287,29742,32545
419,강북구 미아동,20242,62154,29680,32474
420,강북구 번1동,20221,55127,27839,27288
421,강북구 번1동,20222,55178,27769,27409
422,강북구 번1동,20223,54957,27698,27259
423,강북구 번1동,20224,54467,27434,27033
424,강북구 번1동,20231,54315,27301,27014
425,강북구 번1동,20232,53940,27022,26918
426,강북구 번1동,20233,53533,26751,26782
427,강북구 번1동,20234,52747,26297,26450
428,강북구 번1동,20241,50700,25214,25486
429,강북구 번1동,20242,49417,24560,24857
430,강북구 번2동,20221,47149,22785,24364
431,강북구 번2동,20222,46714,22571,24143
432,강북구 번2동,20223,46422,22418,24004
433,강북구 번2동,20224,46066,22217,23849
434,강북구 번2동,20231,45758,22088,23670
435,강북구 번2동,20232,45438,21861,23577
436,강북구 번2동,20233,45059,21592,23467
437,강북구 번2동,20234,44697,21439,23258
438,강북구 번2동,20241,44488,21325,23163
439,강북구 번2동,20242,44305,21231,23074
440,강북구 번3동,20221,50258,23527,26731
441,강북구 번3동,20222,49879,23329,26550
442,강북구 번3동,20223,49576,23177,26399
443,강북구 번3동,20224,49275,23049,26226
444,강북구 번3동,20231,48909,22849,26060
445,강북구 번3동,20232,49273,22970,26303
446,강북구 번3동,20233,49318,22997,26321
447,강북구 번3동,20234,49083,22858,26225
448,강북구 번3동,20241,48862,22713,26149
449,강북구 번3동,20242,48559,22552,26007
450,강북구 삼각산동,20221,93479,44870,48609
451,강북구 삼각산동,20222,92876,44604,48272
452,강북구 삼각산동,20223,92501,44392,48109
453,강북구 삼각산동,20224,92390,44310,48080
454,강북구 삼각산동,20231,92343,44280,48063
455,강북구 삼각산동,20232,92249,44270,47979
456,강북구 삼각산동,20233,92225,44255,47970
457,강북구 삼각산동,20234,91884,44076,47808
458,강북구 삼각산동,20241,91667,43968,47699
459,강북구 삼각산동,20242,91242,43742,47500
460,강북구 삼양동,20221,70548,35243,35305
461,강북구 삼양동,20222,70222,35074,35148
462,강북구 삼양동,20223,69591,34703,34888
463,강북구 삼양동,20224,68870,34318,34552
464,강북구 삼양동,20231,68536,34150,34386
465,강북구 삼양동,20232,68230,33992,34238
466,강북구 삼양동,20233,67821,33795,34026
467,강북구 삼양동,20234,67341,33522,33819
468,강북구 삼양동,20241,67014,33348,33666
469,강북구 삼양동,20242,66726,33105,33621
470,강북구 송중동,20221,88144,42413,45731
471,강북구 송중동,20222,88081,42356,45725
472,강북구 송중동,20223,88412,42524,45888
473,강북구 송중동,20224,88015,42343,45672
474,강북구 송중동,20231,87624,42199,45425
475,강북구 송중동,20232,87077,42014,45063
476,강북구 송중동,20233,86529,41655,44874
477,강북구 송중동,20234,85973,41356,44617
478,강북구 송중동,20241,85590,41123,44467
479,강북구 송중동,20242,85039,40836,44203
480,강북구 송천동,20221,78574,38953,39621
481,강북구 송천동,20222,77880,38541,39339
482,강북구 송천동,20223,77434,38278,39156
483,강북구 송천동,20224,76820,37999,38821
484,강북구 송천동,20231,76519,37875,38644
485,강북구 송천동,20232,75788,37587,38201
486,강북구 송천동,20233,75158,37355,37803
487,강북구 송천동,20234,74423,36946,37477
488,강북구 송천동,20241,74099,36780,37319
489,강북구 송천동,20242,73741,36602,37139
490,강북구 수유1동,20221,61787,30463,31324
491,강북구 수유1동,20222,61399,30193,31206
492,강북구 수유1동,20223,61494,30251,31243
493,강북구 수유1동,20224,60947,29958,30989
494,강북구 수유1동,20231,60732,29822,30910
495,강북구 수유1동,20232,60414,29595,30819
496,강북구 수유1동,20233,60058,29453,30605
497,강북구 수유1동,20234,59728,29252,30476
498,강북구 수유1동,20241,59435,29029,30406
499,강북구 수유1동,20242,59236,28924,30312
500,강북구 수유2동,20221,63642,30357,33285
501,강북구 수유2동,20222,63401,30171,33230
502,강북구 수유2동,20223,63128,30010,33118
503,강북구 수유2동,20224,62723,29833,32890
504,강북구 수유2동,20231,62575,29754,32821
505,강북구 수유2동,20232,62357,29617,32740
506,강북구 수유2동,20233,62080,29423,32657
507,강북구 수유2동,20234,61716,29248,32468
508,강북구 수유2동,20241,61433,29097,32336
509,강북구 수유2동,20242,61235,29031,32204
510,강북구 수유3동,20221,69023,34360,34663
511,강북구 수유3동,20222,69226,34379,34847
512,강북구 수유3동,20223,69244,34321,34923
513,강북구 수유3동,20224,69050,34126,34924
514,강북구 수유3동,20231,69022,34080,34942
515,강북구 수유3동,20232,68998,33956,35042
516,강북구 수유3동,20233,69136,33915,35221
517,강북구 수유3동,20234,69010,33887,35123
518,강북구 수유3동,20241,69018,33875,35143
519,강북구 수유3동,20242,68769,33730,35039
520,강북구 우이동,20221,61383,29655,31728
521,강북구 우이동,20222,61229,29522,31707
522,강북구 우이동,20223,61103,29465,31638
523,강북구 우이동,20224,60749,29257,31492
524,강북구 우이동,20231,60532,29081,31451
525,강북구 우이동,20232,60253,28914,31339
526,강북구 우이동,20233,59894,28713,31181
527,강북구 우이동,20234,59558,28493,31065
528,강북구 우이동,20241,59392,28377,31015
529,강북구 우이동,20242,59467,28311,31156
530,강북구 인수동,20221,90766,43850,46916
531,강북구 인수동,20222,90187,43541,46646
532,강북구 인수동,20223,89675,43257,46418
533,강북구 인수동,20224,89197,42990,46207
534,강북구 인수동,20231,88929,42821,46108
535,강북구 인수동,20232,88466,42634,45832
536,강북구 인수동,20233,87925,42442,45483
537,강북구 인수동,20234,87378,42165,45213
538,강북구 인수동,20241,86945,41870,45075
539,강북구 인수동,20242,86576,41648,44928
540,강서구 가양1동,20221,102339,46731,55608
541,강서구 가양1동,20222,102458,46710,55748
542,강서구 가양1동,20223,102526,46682,55844
543,강서구 가양1동,20224,102347,46642,55705
544,강서구 가양1동,20231,102279,46455,55824
545,강서구 가양1동,20232,102229,46231,55998
546,강서구 가양1동,20233,102021,45945,56076
547,강서구 가양1동,20234,101847,45717,56130
548,강서구 가양1동,20241,101376,45480,55896
549,강서구 가양1동,20242,101030,45374,55656
550,강서구 가양2동,20221,41870,19805,22065
551,강서구 가양2동,20222,41782,19732,22050
552,강서구 가양2동,20223,41826,19756,22070
553,강서구 가양2동,20224,41523,19590,21933
554,강서구 가양2동,20231,41331,19512,21819
555,강서구 가양2동,20232,40940,19275,21665
556,강서구 가양2동,20233,40649,19086,21563
557,강서구 가양2동,20234,40437,18974,21463
558,강서구 가양2동,20241,40280,18906,21374
559,강서구 가양2동,20242,40082,18814,21268
560,강서구 가양3동,20221,44856,20840,24016
561,강서구 가양3동,20222,44534,20722,23812
562,강서구 가양3동,20223,44182,20531,23651
563,강서구 가양3동,20224,43813,20314,23499
564,강서구 가양3동,20231,43502,20170,23332
565,강서구 가양3동,20232,43296,20010,23286
566,강서구 가양3동,20233,42869,19744,23125
567,강서구 가양3동,20234,42499,19496,23003
568,강서구 가양3동,20241,42107,19305,22802
569,강서구 가양3동,20242,41977,19317,22660
570,강서구 공항동,20221,92226,46525,45701
571,강서구 공항동,20222,92109,46425,45684
572,강서구 공항동,20223,91802,46297,45505
573,강서구 공항동,20224,91207,46043,45164
574,강서구 공항동,20231,90757,45834,44923
575,강서구 공항동,20232,90265,45717,44548
576,강서구 공항동,20233,89532,45244,44288
577,강서구 공항동,20234,88658,44773,43885
578,강서구 공항동,20241,88222,44561,43661
579,강서구 공항동,20242,88231,44578,43653
580,강서구 등촌1동,20221,73078,33834,39244
581,강서구 등촌1동,20222,74145,34236,39909
582,강서구 등촌1동,20223,74411,34362,40049
583,강서구 등촌1동,20224,74330,34245,40085
584,강서구 등촌1동,20231,74286,34239,40047
585,강서구 등촌1동,20232,74459,34319,40140
586,강서구 등촌1동,20233,74591,34398,40193
587,강서구 등촌1동,20234,74789,34500,40289
588,강서구 등촌1동,20241,74900,34600,40300
589,강서구 등촌1동,20242,75105,34562,40543
590,강서구 등촌2동,20221,60622,29582,31040
591,강서구 등촌2동,20222,60075,29242,30833
592,강서구 등촌2동,20223,59632,28995,30637
593,강서구 등촌2동,20224,59294,28831,30463
594,강서구 등촌2동,20231,58993,28651,30342
595,강서구 등촌2동,20232,58612,28467,30145
596,강서구 등촌2동,20233,58360,28334,30026
597,강서구 등촌2동,20234,58130,28256,29874
598,강서구 등촌2동,20241,57832,28121,29711
599,강서구 등촌2동,20242,57681,28118,29563
600,강서구 등촌3동,20221,91545,43289,48256
601,강서구 등촌3동,20222,91126,43080,48046
602,강서구 등촌3동,20223,90372,42796,47576
603,강서구 등촌3동,20224,89803,42526,47277
604,강서구 등촌3동,20231,89099,42132,46967
605,강서구 등촌3동,20232,88770,41982,46788
606,강서구 등촌3동,20233,88737,41950,46787
607,강서구 등촌3동,20234,88356,41696,46660
608,강서구 등촌3동,20241,88051,41425,46626
609,강서구 등촌3동,20242,87704,41207,46497
610,강서구 발산1동,20221,108878,51365,57513
611,강서구 발산1동,20222,108656,51227,57429
612,강서구 발산1동,20223,108429,51116,57313
613,강서구 발산1동,20224,107954,50903,57051
614,강서구 발산1동,20231,107765,50765,57000
615,강서구 발산1동,20232,107639,50673,56966
616,강서구 발산1동,20233,107241,50546,56695
617,강서구 발산1동,20234,107088,50463,56625
618,강서구 발산1동,20241,106693,50317,56376
619,강서구 발산1동,20242,106295,50132,56163
620,강서구 방화1동,20221,128275,62480,65795
621,강서구 방화1동,20222,127996,62381,65615
622,강서구 방화1동,20223,128162,62437,65725
623,강서구 방화1동,20224,127948,62312,65636
624,강서구 방화1동,20231,127658,62184,65474
625,강서구 방화1동,20232,127534,62094,65440
626,강서구 방화1동,20233,127014,61849,65165
627,강서구 방화1동,20234,126263,61556,64707
628,강서구 방화1동,20241,125570,61290,64280
629,강서구 방화1동,20242,125002,61016,63986
630,강서구 방화2동,20221,69853,34487,35366
631,강서구 방화2동,20222,69768,34401,35367
632,강서구 방화2동,20223,69634,34362,35272
633,강서구 방화2동,20224,69386,34306,35080
634,강서구 방화2동,20231,69108,34175,34933
635,강서구 방화2동,20232,68642,33924,34718
636,강서구 방화2동,20233,68433,33796,34637
637,강서구 방화2동,20234,68119,33669,34450
638,강서구 방화2동,20241,67944,33605,34339
639,강서구 방화2동,20242,67868,33536,34332
640,강서구 방화3동,20221,68070,32996,35074
641,강서구 방화3동,20222,67858,32893,34965
642,강서구 방화3동,20223,67581,32655,34926
643,강서구 방화3동,20224,67281,32445,34836
644,강서구 방화3동,20231,67039,32313,34726
645,강서구 방화3동,20232,66748,32157,34591
646,강서구 방화3동,20233,66346,32009,34337
647,강서구 방화3동,20234,66064,31909,34155
648,강서구 방화3동,20241,65795,31770,34025
649,강서구 방화3동,20242,65574,31602,33972
650,강서구 염창동,20221,124765,60297,64468
651,강서구 염창동,20222,124854,60316,64538
652,강서구 염창동,20223,125001,60291,64710
653,강서구 염창동,20224,124562,59975,64587
654,강서구 염창동,20231,124223,59721,64502
655,강서구 염창동,20232,124096,59694,64402
656,강서구 염창동,20233,124058,59584,64474
657,강서구 염창동,20234,124059,59566,64493
658,강서구 염창동,20241,123922,59508,64414
659,강서구 염창동,20242,123903,59534,64369
660,강서구 우장산동,20221,128450,61442,67008
661,강서구 우장산동,20222,127821,61125,66696
662,강서구 우장산동,20223,127496,60913,66583
663,강서구 우장산동,20224,127447,60876,66571
664,강서구 우장산동,20231,129775,61993,67782
665,강서구 우장산동,20232,131152,62705,68447
666,강서구 우장산동,20233,131382,62828,68554
667,강서구 우장산동,20234,131235,62715,68520
668,강서구 우장산동,20241,131092,62575,68517
669,강서구 우장산동,20242,130813,62398,68415
670,강서구 화곡1동,20221,155566,75644,79922
671,강서구 화곡1동,20222,155543,75550,79993
672,강서구 화곡1동,20223,155615,75662,79953
673,강서구 화곡1동,20224,155130,75336,79794
674,강서구 화곡1동,20231,155283,75433,79850
675,강서구 화곡1동,20232,155060,75363,79697
676,강서구 화곡1동,20233,154309,75019,79290
677,강서구 화곡1동,20234,152756,74230,78526
678,강서구 화곡1동,20241,152046,73821,78225
679,강서구 화곡1동,20242,151079,73332,77747
680,강서구 화곡2동,20221,53269,25806,27463
681,강서구 화곡2동,20222,53125,25670,27455
682,강서구 화곡2동,20223,52945,25628,27317
683,강서구 화곡2동,20224,52631,25432,27199
684,강서구 화곡2동,20231,52392,25313,27079
685,강서구 화곡2동,20232,52136,25143,26993
686,강서구 화곡2동,20233,51719,24914,26805
687,강서구 화곡2동,20234,51295,24665,26630
688,강서구 화곡2동,20241,51077,24534,26543
689,강서구 화곡2동,20242,50915,24474,26441
690,강서구 화곡3동,20221,64675,30861,33814
691,강서구 화곡3동,20222,64572,30769,33803
692,강서구 화곡3동,20223,64521,30739,33782
693,강서구 화곡3동,20224,64435,30699,33736
694,강서구 화곡3동,20231,64164,30525,33639
695,강서구 화곡3동,20232,63904,30411,33493
696,강서구 화곡3동,20233,63861,30397,33464
697,강서구 화곡3동,20234,63402,30227,33175
698,강서구 화곡3동,20241,63295,30150,33145
699,강서구 화곡3동,20242,62926,29922,33004
700,강서구 화곡4동,20221,61539,30100,31439
701,강서구 화곡4동,20222,61375,30069,31306
702,강서구 화곡4동,20223,61122,29950,31172
703,강서구 화곡4동,20224,60817,29832,30985
704,강서구 화곡4동,20231,60366,29608,30758
705,강서구 화곡4동,20232,59907,29396,30511
706,강서구 화곡4동,20233,59651,29274,30377
707,강서구 화곡4동,20234,59313,29076,30237
708,강서구 화곡4동,20241,58882,28921,29961
709,강서구 화곡4동,20242,58610,28761,29849
710,강서구 화곡6동,20221,74820,36136,38684
711,강서구 화곡6동,20222,75052,36094,38958
712,강서구 화곡6동,20223,75226,36086,39140
713,강서구 화곡6동,20224,75080,36046,39034
714,강서구 화곡6동,20231,74975,35932,39043
715,강서구 화곡6동,20232,74777,35763,39014
716,강서구 화곡6동,20233,74410,35629,38781
717,강서구 화곡6동,20234,76425,36623,39802
718,강서구 화곡6동,20241,78046,37329,40717
719,강서구 화곡6동,20242,77786,37167,40619
720,강서구 화곡8동,20221,73165,35279,37886
721,강서구 화곡8동,20222,73199,35291,37908
722,강서구 화곡8동,20223,72869,35203,37666
723,강서구 화곡8동,20224,72252,34874,37378
724,강서구 화곡8동,20231,71881,34682,37199
725,강서구 화곡8동,20232,71463,34448,37015
726,강서구 화곡8동,20233,70994,34187,36807
727,강서구 화곡8동,20234,70567,34029,36538
728,강서구 화곡8동,20241,70105,33833,36272
729,강서구 화곡8동,20242,69265,33391,35874
730,강서구 화곡본동,20221,102717,49765,52952
731,강서구 화곡본동,20222,102604,49600,53004
732,강서구 화곡본동,20223,102060,49270,52790
733,강서구 화곡본동,20224,101393,48977,52416
734,강서구 화곡본동,20231,100882,48808,52074
735,강서구 화곡본동,20232,100330,48515,51815
736,강서구 화곡본동,20233,99690,48212,51478
737,강서구 화곡본동,20234,98994,47926,51068
738,강서구 화곡본동,20241,98768,47780,50988
739,강서구 화곡본동,20242,98265,47523,50742
740,관악구 낙성대동,20221,50862,25583,25279
741,관악구 낙성대동,20222,51396,25832,25564
742,관악구 낙성대동,20223,52040,26188,25852
743,관악구 낙성대동,20224,52076,26163,25913
744,관악구 낙성대동,20231,52111,26145,25966
745,관악구 낙성대동,20232,52458,26308,26150
746,관악구 낙성대동,20233,52531,26358,26173
747,관악구 낙성대동,20234,52038,26119,25919
748,관악구 낙성대동,20241,52015,26040,25975
749,관악구 낙성대동,20242,52327,26255,26072
750,관악구 난곡동,20221,80043,40170,39873
751,관악구 난곡동,20222,79720,39986,39734
752,관악구 난곡동,20223,79393,39827,39566
753,관악구 난곡동,20224,78914,39555,39359
754,관악구 난곡동,20231,78177,39102,39075
755,관악구 난곡동,20232,77527,38789,38738
756,관악구 난곡동,20233,76992,38573,38419
757,관악구 난곡동,20234,76170,38144,38026
758,관악구 난곡동,20241,75688,37833,37855
759,관악구 난곡동,20242,75408,37698,37710
760,관악구 난향동,20221,45792,22384,23408
761,관악구 난향동,20222,45533,22246,23287
762,관악구 난향동,20223,45338,22167,23171
763,관악구 난향동,20224,44916,21976,22940
764,관악구 난향동,20231,44648,21852,22796
765,관악구 난향동,20232,44550,21811,22739
766,관악구 난향동,20233,44451,21739,22712
767,관악구 난향동,20234,44244,21629,22615
768,관악구 난향동,20241,44050,21514,22536
769,관악구 난향동,20242,44056,21480,22576
770,관악구 남현동,20221,54233,26166,28067
771,관악구 남현동,20222,54177,26147,28030
772,관악구 남현동,20223,54242,26219,28023
773,관악구 남현동,20224,53953,26098,27855
774,관악구 남현동,20231,53792,26062,27730
775,관악구 남현동,20232,53582,25991,27591
776,관악구 남현동,20233,53417,25892,27525
777,관악구 남현동,20234,53194,25735,27459
778,관악구 남현동,20241,53201,25765,27436
779,관악구 남현동,20242,53090,25626,27464
780,관악구 대학동,20221,70129,42343,27786
781,관악구 대학동,20222,70428,42617,27811
782,관악구 대학동,20223,71006,43106,27900
783,관악구 대학동,20224,71829,43656,28173
784,관악구 대학동,20231,72735,44273,28462
785,관악구 대학동,20232,73524,44815,28709
786,관악구 대학동,20233,73640,44959,28681
787,관악구 대학동,20234,73102,44669,28433
788,관악구 대학동,20241,73150,44702,28448
789,관악구 대학동,20242,73371,44966,28405
790,관악구 미성동,20221,91469,44805,46664
791,관악구 미성동,20222,91585,44813,46772
792,관악구 미성동,20223,91026,44569,46457
793,관악구 미성동,20224,90448,44290,46158
794,관악구 미성동,20231,90024,44068,45956
795,관악구 미성동,20232,89845,43987,45858
796,관악구 미성동,20233,89360,43750,45610
797,관악구 미성동,20234,88856,43524,45332
798,관악구 미성동,20241,88303,43262,45041
799,관악구 미성동,20242,87841,43076,44765
800,관악구 보라매동,20221,73416,36120,37296
801,관악구 보라매동,20222,73309,36069,37240
802,관악구 보라매동,20223,73109,35978,37131
803,관악구 보라매동,20224,72733,35703,37030
804,관악구 보라매동,20231,72704,35778,36926
805,관악구 보라매동,20232,72456,35751,36705
806,관악구 보라매동,20233,72051,35583,36468
807,관악구 보라매동,20234,71562,35398,36164
808,관악구 보라매동,20241,71148,35082,36066
809,관악구 보라매동,20242,70872,34925,35947
810,관악구 삼성동,20221,64305,32164,32141
811,관악구 삼성동,20222,63209,31570,31639
812,관악구 삼성동,20223,62396,31129,31267
813,관악구 삼성동,20224,61645,30724,30921
814,관악구 삼성동,20231,61262,30498,30764
815,관악구 삼성동,20232,60805,30261,30544
816,관악구 삼성동,20233,60471,30144,30327
817,관악구 삼성동,20234,60076,29881,30195
818,관악구 삼성동,20241,59714,29690,30024
819,관악구 삼성동,20242,59315,29444,29871
820,관악구 서림동,20221,69192,38176,31016
821,관악구 서림동,20222,69668,38545,31123
822,관악구 서림동,20223,69843,38685,31158
823,관악구 서림동,20224,70153,38957,31196
824,관악구 서림동,20231,70623,39291,31332
825,관악구 서림동,20232,70863,39478,31385
826,관악구 서림동,20233,70572,39206,31366
827,관악구 서림동,20234,70177,39010,31167
828,관악구 서림동,20241,70212,39087,31125
829,관악구 서림동,20242,70211,39056,31155
830,관악구 서원동,20221,68112,35320,32792
831,관악구 서원동,20222,68587,35735,32852
832,관악구 서원동,20223,68788,35920,32868
833,관악구 서원동,20224,68469,35827,32642
834,관악구 서원동,20231,68643,35971,32672
835,관악구 서원동,20232,68785,36054,32731
836,관악구 서원동,20233,69060,36137,32923
837,관악구 서원동,20234,68864,36078,32786
838,관악구 서원동,20241,69180,36317,32863
839,관악구 서원동,20242,69226,36368,32858
840,관악구 성현동,20221,87205,42057,45148
841,관악구 성현동,20222,86787,41882,44905
842,관악구 성현동,20223,86615,41764,44851
843,관악구 성현동,20224,86093,41497,44596
844,관악구 성현동,20231,85691,41301,44390
845,관악구 성현동,20232,85484,41143,44341
846,관악구 성현동,20233,85240,40971,44269
847,관악구 성현동,20234,84926,40875,44051
848,관악구 성현동,20241,84554,40673,43881
849,관악구 성현동,20242,84308,40599,43709
850,관악구 신림동,20221,67696,35801,31895
851,관악구 신림동,20222,68638,36282,32356
852,관악구 신림동,20223,69342,36663,32679
853,관악구 신림동,20224,69220,36636,32584
854,관악구 신림동,20231,69772,36800,32972
855,관악구 신림동,20232,70114,36972,33142
856,관악구 신림동,20233,69720,36877,32843
857,관악구 신림동,20234,68677,36524,32153
858,관악구 신림동,20241,68730,36675,32055
859,관악구 신림동,20242,68982,36830,32152
860,관악구 신사동,20221,67898,34106,33792
861,관악구 신사동,20222,68265,34241,34024
862,관악구 신사동,20223,68485,34392,34093
863,관악구 신사동,20224,67997,34110,33887
864,관악구 신사동,20231,67998,34036,33962
865,관악구 신사동,20232,68114,34062,34052
866,관악구 신사동,20233,67791,34007,33784
867,관악구 신사동,20234,66974,33647,33327
868,관악구 신사동,20241,66786,33484,33302
869,관악구 신사동,20242,66780,33435,33345
870,관악구 신원동,20221,53781,27230,26551
871,관악구 신원동,20222,53844,27256,26588
872,관악구 신원동,20223,53889,27333,26556
873,관악구 신원동,20224,53677,27189,26488
874,관악구 신원동,20231,53722,27247,26475
875,관악구 신원동,20232,53522,27209,26313
876,관악구 신원동,20233,53331,27169,26162
877,관악구 신원동,20234,52853,26985,25868
878,관악구 신원동,20241,52675,27037,25638
879,관악구 신원동,20242,52656,27033,25623
880,관악구 은천동,20221,99306,48478,50828
881,관악구 은천동,20222,98879,48257,50622
882,관악구 은천동,20223,98633,48089,50544
883,관악구 은천동,20224,98212,47964,50248
884,관악구 은천동,20231,98106,47963,50143
885,관악구 은천동,20232,97977,48002,49975
886,관악구 은천동,20233,97674,47799,49875
887,관악구 은천동,20234,97282,47585,49697
888,관악구 은천동,20241,97012,47471,49541
889,관악구 은천동,20242,96780,47353,49427
890,관악구 인헌동,20221,77512,37695,39817
891,관악구 인헌동,20222,77737,37788,39949
892,관악구 인헌동,20223,77608,37734,39874
893,관악구 인헌동,20224,77322,37581,39741
894,관악구 인헌동,20231,77234,37444,39790
895,관악구 인헌동,20232,77192,37322,39870
896,관악구 인헌동,20233,76810,37199,39611
897,관악구 인헌동,20234,76507,37050,39457
898,관악구 인헌동,20241,76110,36892,39218
899,관악구 인헌동,20242,75758,36708,39050
900,관악구 조원동,20221,52363,26357,26006
901,관악구 조원동,20222,52533,26402,26131
902,관악구 조원동,20223,53138,26604,26534
903,관악구 조원동,20224,56909,28495,28414
904,관악구 조원동,20231,58184,29081,29103
905,관악구 조원동,20232,58747,29248,29499
906,관악구 조원동,20233,58795,29236,29559
907,관악구 조원동,20234,58870,29365,29505
908,관악구 조원동,20241,58994,29412,29582
909,관악구 조원동,20242,58971,29426,29545
910,관악구 중앙동,20221,45596,21918,23678
911,관악구 중앙동,20222,45920,22058,23862
912,관악구 중앙동,20223,46106,22216,23890
913,관악구 중앙동,20224,46011,22174,23837
914,관악구 중앙동,20231,46160,22304,23856
915,관악구 중앙동,20232,46174,22362,23812
916,관악구 중앙동,20233,45994,22281,23713
917,관악구 중앙동,20234,45700,22061,23639
918,관악구 중앙동,20241,45744,22034,23710
919,관악구 중앙동,20242,45825,21988,23837
920,관악구 청룡동,20221,106921,51528,55393
921,관악구 청룡동,20222,107241,51851,55390
922,관악구 청룡동,20223,107870,52099,55771
923,관악구 청룡동,20224,108062,52058,56004
924,관악구 청룡동,20231,108389,52069,56320
925,관악구 청룡동,20232,108415,51924,56491
926,관악구 청룡동,20233,108142,51870,56272
927,관악구 청룡동,20234,107591,51701,55890
928,관악구 청룡동,20241,107664,51835,55829
929,관악구 청룡동,20242,107864,51946,55918
930,관악구 청림동,20221,45253,21973,23280
931,관악구 청림동,20222,45010,21816,23194
932,관악구 청림동,20223,44991,21764,23227
933,관악구 청림동,20224,44815,21664,23151
934,관악구 청림동,20231,44777,21653,23124
935,관악구 청림동,20232,44682,21600,23082
936,관악구 청림동,20233,44436,21474,22962
937,관악구 청림동,20234,44227,21340,22887
938,관악구 청림동,20241,44002,21245,22757
939,관악구 청림동,20242,43896,21106,22790
940,관악구 행운동,20221,87110,42289,44821
941,관악구 행운동,20222,87527,42456,45071
942,관악구 행운동,20223,87730,42465,45265
943,관악구 행운동,20224,87537,42380,45157
944,관악구 행운동,20231,87356,42303,45053
945,관악구 행운동,20232,87479,42440,45039
946,관악구 행운동,20233,87321,42306,45015
947,관악구 행운동,20234,86717,41989,44728
948,관악구 행운동,20241,86732,42016,44716
949,관악구 행운동,20242,86762,41992,44770
950,광진구 광장동,20221,103795,50257,53538
951,광진구 광장동,20222,103242,49995,53247
952,광진구 광장동,20223,102978,49834,53144
953,광진구 광장동,20224,102674,49636,53038
954,광진구 광장동,20231,102220,49413,52807
955,광진구 광장동,20232,102161,49461,52700
956,광진구 광장동,20233,102203,49504,52699
957,광진구 광장동,20234,102056,49395,52661
958,광진구 광장동,20241,101805,49266,52539
959,광진구 광장동,20242,101579,49071,52508
960,광진구 구의1동,20221,67186,31966,35220
961,광진구 구의1동,20222,69385,33065,36320
962,광진구 구의1동,20223,70114,33397,36717
963,광진구 구의1동,20224,70124,33423,36701
964,광진구 구의1동,20231,70240,33484,36756
965,광진구 구의1동,20232,70127,33516,36611
966,광진구 구의1동,20233,69799,33394,36405
967,광진구 구의1동,20234,69444,33189,36255
968,광진구 구의1동,20241,69317,33101,36216
969,광진구 구의1동,20242,69243,32937,36306
970,광진구 구의2동,20221,79374,38315,41059
971,광진구 구의2동,20222,79003,38021,40982
972,광진구 구의2동,20223,78648,37819,40829
973,광진구 구의2동,20224,78252,37613,40639
974,광진구 구의2동,20231,77723,37281,40442
975,광진구 구의2동,20232,77570,37123,40447
976,광진구 구의2동,20233,77342,36970,40372
977,광진구 구의2동,20234,76931,36730,40201
978,광진구 구의2동,20241,76882,36641,40241
979,광진구 구의2동,20242,76607,36482,40125
980,광진구 구의3동,20221,85704,40522,45182
981,광진구 구의3동,20222,85436,40399,45037
982,광진구 구의3동,20223,85153,40235,44918
983,광진구 구의3동,20224,84724,39982,44742
984,광진구 구의3동,20231,84607,39898,44709
985,광진구 구의3동,20232,84309,39759,44550
986,광진구 구의3동,20233,83761,39507,44254
987,광진구 구의3동,20234,83479,39415,44064
988,광진구 구의3동,20241,83510,39416,44094
989,광진구 구의3동,20242,83388,39274,44114
990,광진구 군자동,20221,58617,28968,29649
991,광진구 군자동,20222,58529,28985,29544
992,광진구 군자동,20223,58563,29007,29556
993,광진구 군자동,20224,58276,28839,29437
994,광진구 군자동,20231,58189,28767,29422
995,광진구 군자동,20232,57894,28631,29263
996,광진구 군자동,20233,57642,28526,29116
997,광진구 군자동,20234,57325,28282,29043
998,광진구 군자동,20241,57047,28058,28989
999,광진구 군자동,20242,56866,27903,28963
1000,광진구 능동,20221,33822,15585,18237
1001,광진구 능동,20222,33804,15594,18210
1002,광진구 능동,20223,33778,15557,18221
1003,광진구 능동,20224,33585,15428,18157
1004,광진구 능동,20231,33516,15397,18119
1005,광진구 능동,20232,33515,15381,18134
1006,광진구 능동,20233,33471,15349,18122
1007,광진구 능동,20234,33303,15242,18061
1008,광진구 능동,20241,33192,15209,17983
1009,광진구 능동,20242,33119,15182,17937
1010,광진구 자양1동,20221,66617,32299,34318
1011,광진구 자양1동,20222,66398,32258,34140
1012,광진구 자양1동,20223,66156,32141,34015
1013,광진구 자양1동,20224,65674,31930,33744
1014,광진구 자양1동,20231,65752,32006,33746
1015,광진구 자양1동,20232,66328,32277,34051
1016,광진구 자양1동,20233,66068,32056,34012
1017,광진구 자양1동,20234,65597,31764,33833
1018,광진구 자양1동,20241,65655,31904,33751
1019,광진구 자양1동,20242,65566,31889,33677
1020,광진구 자양2동,20221,73636,35640,37996
1021,광진구 자양2동,20222,72938,35350,37588
1022,광진구 자양2동,20223,72363,35106,37257
1023,광진구 자양2동,20224,71798,34799,36999
1024,광진구 자양2동,20231,71510,34708,36802
1025,광진구 자양2동,20232,71229,34553,36676
1026,광진구 자양2동,20233,71076,34481,36595
1027,광진구 자양2동,20234,70924,34439,36485
1028,광진구 자양2동,20241,70918,34326,36592
1029,광진구 자양2동,20242,70889,34343,36546
1030,광진구 자양3동,20221,83774,40051,43723
1031,광진구 자양3동,20222,83497,39948,43549
1032,광진구 자양3동,20223,83127,39743,43384
1033,광진구 자양3동,20224,82694,39515,43179
1034,광진구 자양3동,20231,82559,39461,43098
1035,광진구 자양3동,20232,82289,39338,42951
1036,광진구 자양3동,20233,81865,39106,42759
1037,광진구 자양3동,20234,81715,39024,42691
1038,광진구 자양3동,20241,81406,38917,42489
1039,광진구 자양3동,20242,81396,38896,42500
1040,광진구 자양4동,20221,53897,26858,27039
1041,광진구 자양4동,20222,53997,26884,27113
1042,광진구 자양4동,20223,53944,26894,27050
1043,광진구 자양4동,20224,53743,26795,26948
1044,광진구 자양4동,20231,53957,26875,27082
1045,광진구 자양4동,20232,53884,26802,27082
1046,광진구 자양4동,20233,57338,28397,28941
1047,광진구 자양4동,20234,59592,29468,30124
1048,광진구 자양4동,20241,59566,29392,30174
1049,광진구 자양4동,20242,59315,29197,30118
1050,광진구 중곡1동,20221,46308,22423,23885
1051,광진구 중곡1동,20222,46019,22248,23771
1052,광진구 중곡1동,20223,45780,22082,23698
1053,광진구 중곡1동,20224,45905,22010,23895
1054,광진구 중곡1동,20231,46164,22036,24128
1055,광진구 중곡1동,20232,46212,21963,24249
1056,광진구 중곡1동,20233,45790,21700,24090
1057,광진구 중곡1동,20234,45765,21697,24068
1058,광진구 중곡1동,20241,45659,21595,24064
1059,광진구 중곡1동,20242,45490,21516,23974
1060,광진구 중곡2동,20221,64174,30247,33927
1061,광진구 중곡2동,20222,63782,30052,33730
1062,광진구 중곡2동,20223,63307,29836,33471
1063,광진구 중곡2동,20224,63016,29724,33292
1064,광진구 중곡2동,20231,62794,29585,33209
1065,광진구 중곡2동,20232,62394,29420,32974
1066,광진구 중곡2동,20233,62031,29245,32786
1067,광진구 중곡2동,20234,61693,29005,32688
1068,광진구 중곡2동,20241,61359,28869,32490
1069,광진구 중곡2동,20242,61039,28757,32282
1070,광진구 중곡3동,20221,48282,23949,24333
1071,광진구 중곡3동,20222,48167,23909,24258
1072,광진구 중곡3동,20223,48032,23779,24253
1073,광진구 중곡3동,20224,47823,23667,24156
1074,광진구 중곡3동,20231,47832,23663,24169
1075,광진구 중곡3동,20232,47689,23550,24139
1076,광진구 중곡3동,20233,47387,23332,24055
1077,광진구 중곡3동,20234,47227,23297,23930
1078,광진구 중곡3동,20241,46974,23151,23823
1079,광진구 중곡3동,20242,46584,22959,23625
1080,광진구 중곡4동,20221,85501,41831,43670
1081,광진구 중곡4동,20222,84971,41554,43417
1082,광진구 중곡4동,20223,84518,41343,43175
1083,광진구 중곡4동,20224,84122,41155,42967
1084,광진구 중곡4동,20231,83752,40943,42809
1085,광진구 중곡4동,20232,83493,40749,42744
1086,광진구 중곡4동,20233,83044,40516,42528
1087,광진구 중곡4동,20234,82812,40338,42474
1088,광진구 중곡4동,20241,82599,40243,42356
1089,광진구 중곡4동,20242,82545,40189,42356
1090,광진구 화양동,20221,70516,33654,36862
1091,광진구 화양동,20222,71183,33940,37243
1092,광진구 화양동,20223,71216,33839,37377
1093,광진구 화양동,20224,70619,33568,37051
1094,광진구 화양동,20231,70315,33481,36834
1095,광진구 화양동,20232,70213,33323,36890
1096,광진구 화양동,20233,70374,33366,37008
1097,광진구 화양동,20234,69839,33084,36755
1098,광진구 화양동,20241,69751,32976,36775
1099,광진구 화양동,20242,69744,32877,36867
1100,구로구 가리봉동,20221,27105,14832,12273
1101,구로구 가리봉동,20222,27196,14835,12361
1102,구로구 가리봉동,20223,27001,14777,12224
1103,구로구 가리봉동,20224,26801,14679,12122
1104,구로구 가리봉동,20231,26848,14721,12127
1105,구로구 가리봉동,20232,26830,14690,12140
1106,구로구 가리봉동,20233,26581,14566,12015
1107,구로구 가리봉동,20234,26317,14452,11865
1108,구로구 가리봉동,20241,26236,14434,11802
1109,구로구 가리봉동,20242,26236,14432,11804
1110,구로구 개봉1동,20221,101113,50408,50705
1111,구로구 개봉1동,20222,100879,50274,50605
1112,구로구 개봉1동,20223,100601,50091,50510
1113,구로구 개봉1동,20224,100147,49831,50316
1114,구로구 개봉1동,20231,99998,49722,50276
1115,구로구 개봉1동,20232,100041,49729,50312
1116,구로구 개봉1동,20233,99915,49649,50266
1117,구로구 개봉1동,20234,99546,49405,50141
1118,구로구 개봉1동,20241,99050,49045,50005
1119,구로구 개봉1동,20242,98567,48808,49759
1120,구로구 개봉2동,20221,92376,44992,47384
1121,구로구 개봉2동,20222,91808,44770,47038
1122,구로구 개봉2동,20223,91565,44624,46941
1123,구로구 개봉2동,20224,90949,44283,46666
1124,구로구 개봉2동,20231,90400,43978,46422
1125,구로구 개봉2동,20232,90447,43925,46522
1126,구로구 개봉2동,20233,90143,43699,46444
1127,구로구 개봉2동,20234,89430,43332,46098
1128,구로구 개봉2동,20241,88879,42993,45886
1129,구로구 개봉2동,20242,88666,42849,45817
1130,구로구 개봉3동,20221,60719,29501,31218
1131,구로구 개봉3동,20222,60638,29441,31197
1132,구로구 개봉3동,20223,60201,29214,30987
1133,구로구 개봉3동,20224,59737,28992,30745
1134,구로구 개봉3동,20231,59563,28905,30658
1135,구로구 개봉3동,20232,59521,28863,30658
1136,구로구 개봉3동,20233,59323,28764,30559
1137,구로구 개봉3동,20234,58920,28581,30339
1138,구로구 개봉3동,20241,58473,28393,30080
1139,구로구 개봉3동,20242,58243,28252,29991
1140,구로구 고척1동,20221,66579,33147,33432
1141,구로구 고척1동,20222,65771,32724,33047
1142,구로구 고척1동,20223,65353,32525,32828
1143,구로구 고척1동,20224,73165,36547,36618
1144,구로구 고척1동,20231,77205,38541,38664
1145,구로구 고척1동,20232,78266,39057,39209
1146,구로구 고척1동,20233,78832,39294,39538
1147,구로구 고척1동,20234,79080,39387,39693
1148,구로구 고척1동,20241,79447,39613,39834
1149,구로구 고척1동,20242,79856,39866,39990
1150,구로구 고척2동,20221,79706,39491,40215
1151,구로구 고척2동,20222,79404,39321,40083
1152,구로구 고척2동,20223,79055,39130,39925
1153,구로구 고척2동,20224,78435,38782,39653
1154,구로구 고척2동,20231,78363,38725,39638
1155,구로구 고척2동,20232,78030,38527,39503
1156,구로구 고척2동,20233,77967,38461,39506
1157,구로구 고척2동,20234,77564,38201,39363
1158,구로구 고척2동,20241,77258,38049,39209
1159,구로구 고척2동,20242,76899,37848,39051
1160,구로구 구로1동,20221,62369,30528,31841
1161,구로구 구로1동,20222,62299,30493,31806
1162,구로구 구로1동,20223,62235,30438,31797
1163,구로구 구로1동,20224,61999,30297,31702
1164,구로구 구로1동,20231,61829,30175,31654
1165,구로구 구로1동,20232,61808,30178,31630
1166,구로구 구로1동,20233,61770,30150,31620
1167,구로구 구로1동,20234,61603,30055,31548
1168,구로구 구로1동,20241,61530,29981,31549
1169,구로구 구로1동,20242,61425,29939,31486
1170,구로구 구로2동,20221,71134,35826,35308
1171,구로구 구로2동,20222,70635,35569,35066
1172,구로구 구로2동,20223,70140,35383,34757
1173,구로구 구로2동,20224,69474,35018,34456
1174,구로구 구로2동,20231,69046,34771,34275
1175,구로구 구로2동,20232,68604,34439,34165
1176,구로구 구로2동,20233,68027,34151,33876
1177,구로구 구로2동,20234,67458,33823,33635
1178,구로구 구로2동,20241,67145,33654,33491
1179,구로구 구로2동,20242,67000,33639,33361
1180,구로구 구로3동,20221,70713,36372,34341
1181,구로구 구로3동,20222,70797,36483,34314
1182,구로구 구로3동,20223,70836,36494,34342
1183,구로구 구로3동,20224,70435,36314,34121
1184,구로구 구로3동,20231,70297,36246,34051
1185,구로구 구로3동,20232,70123,36167,33956
1186,구로구 구로3동,20233,70005,36217,33788
1187,구로구 구로3동,20234,69938,36204,33734
1188,구로구 구로3동,20241,69714,36009,33705
1189,구로구 구로3동,20242,69465,35864,33601
1190,구로구 구로4동,20221,58858,28503,30355
1191,구로구 구로4동,20222,58407,28235,30172
1192,구로구 구로4동,20223,58100,28062,30038
1193,구로구 구로4동,20224,57673,27876,29797
1194,구로구 구로4동,20231,57346,27722,29624
1195,구로구 구로4동,20232,57020,27513,29507
1196,구로구 구로4동,20233,56595,27305,29290
1197,구로구 구로4동,20234,56157,27056,29101
1198,구로구 구로4동,20241,55803,26888,28915
1199,구로구 구로4동,20242,55397,26635,28762
1200,구로구 구로5동,20221,87923,42633,45290
1201,구로구 구로5동,20222,88486,42799,45687
1202,구로구 구로5동,20223,88463,42743,45720
1203,구로구 구로5동,20224,87941,42511,45430
1204,구로구 구로5동,20231,87932,42573,45359
1205,구로구 구로5동,20232,88015,42628,45387
1206,구로구 구로5동,20233,87764,42533,45231
1207,구로구 구로5동,20234,87451,42458,44993
1208,구로구 구로5동,20241,87460,42504,44956
1209,구로구 구로5동,20242,87405,42494,44911
1210,구로구 수궁동,20221,70157,34588,35569
1211,구로구 수궁동,20222,69819,34398,35421
1212,구로구 수궁동,20223,69568,34235,35333
1213,구로구 수궁동,20224,69209,34018,35191
1214,구로구 수궁동,20231,68925,33836,35089
1215,구로구 수궁동,20232,68655,33667,34988
1216,구로구 수궁동,20233,68470,33555,34915
1217,구로구 수궁동,20234,68257,33414,34843
1218,구로구 수궁동,20241,67957,33234,34723
1219,구로구 수궁동,20242,67728,33091,34637
1220,구로구 신도림동,20221,108073,52470,55603
1221,구로구 신도림동,20222,107991,52432,55559
1222,구로구 신도림동,20223,107816,52271,55545
1223,구로구 신도림동,20224,107583,52083,55500
1224,구로구 신도림동,20231,107380,51895,55485
1225,구로구 신도림동,20232,107192,51707,55485
1226,구로구 신도림동,20233,107231,51780,55451
1227,구로구 신도림동,20234,107814,51947,55867
1228,구로구 신도림동,20241,108255,52091,56164
1229,구로구 신도림동,20242,108189,52064,56125
1230,구로구 오류1동,20221,67483,32725,34758
1231,구로구 오류1동,20222,67206,32526,34680
1232,구로구 오류1동,20223,67126,32382,34744
1233,구로구 오류1동,20224,67464,32383,35081
1234,구로구 오류1동,20231,67889,32395,35494
1235,구로구 오류1동,20232,67934,32420,35514
1236,구로구 오류1동,20233,68247,32514,35733
1237,구로구 오류1동,20234,68079,32389,35690
1238,구로구 오류1동,20241,67977,32382,35595
1239,구로구 오류1동,20242,67811,32321,35490
1240,구로구 오류2동,20221,115206,55423,59783
1241,구로구 오류2동,20222,114754,55135,59619
1242,구로구 오류2동,20223,114717,55029,59688
1243,구로구 오류2동,20224,114032,54574,59458
1244,구로구 오류2동,20231,113734,54363,59371
1245,구로구 오류2동,20232,113192,54048,59144
1246,구로구 오류2동,20233,112897,53922,58975
1247,구로구 오류2동,20234,112184,53524,58660
1248,구로구 오류2동,20241,111313,53061,58252
1249,구로구 오류2동,20242,109883,52323,57560
1250,구로구 항동,20221,49239,24078,25161
1251,구로구 항동,20222,49461,24150,25311
1252,구로구 항동,20223,49395,24071,25324
1253,구로구 항동,20224,49294,23987,25307
1254,구로구 항동,20231,49311,23957,25354
1255,구로구 항동,20232,49227,23919,25308
1256,구로구 항동,20233,49271,23911,25360
1257,구로구 항동,20234,49033,23739,25294
1258,구로구 항동,20241,48872,23647,25225
1259,구로구 항동,20242,48871,23645,25226
1260,금천구 가산동,20221,71404,38652,32752
1261,금천구 가산동,20222,72030,38909,33121
1262,금천구 가산동,20223,72634,39160,33474
1263,금천구 가산동,20224,72700,39145,33555
1264,금천구 가산동,20231,72743,39200,33543
1265,금천구 가산동,20232,73677,39638,34039
1266,금천구 가산동,20233,74125,39886,34239
1267,금천구 가산동,20234,74042,39878,34164
1268,금천구 가산동,20241,74812,40252,34560
1269,금천구 가산동,20242,75042,40420,34622
1270,금천구 독산1동,20221,135479,69378,66101
1271,금천구 독산1동,20222,136932,70167,66765
1272,금천구 독산1동,20223,137492,70345,67147
1273,금천구 독산1동,20224,137492,70267,67225
1274,금천구 독산1동,20231,138250,70654,67596
1275,금천구 독산1동,20232,138854,70827,68027
1276,금천구 독산1동,20233,139278,70886,68392
1277,금천구 독산1동,20234,139116,70688,68428
1278,금천구 독산1동,20241,139536,70874,68662
1279,금천구 독산1동,20242,140633,71379,69254
1280,금천구 독산2동,20221,56103,28407,27696
1281,금천구 독산2동,20222,55807,28255,27552
1282,금천구 독산2동,20223,55415,27992,27423
1283,금천구 독산2동,20224,54731,27660,27071
1284,금천구 독산2동,20231,54466,27471,26995
1285,금천구 독산2동,20232,54200,27314,26886
1286,금천구 독산2동,20233,53966,27161,26805
1287,금천구 독산2동,20234,53549,26932,26617
1288,금천구 독산2동,20241,53294,26847,26447
1289,금천구 독산2동,20242,52936,26694,26242
1290,금천구 독산3동,20221,72574,36337,36237
1291,금천구 독산3동,20222,72733,36399,36334
1292,금천구 독산3동,20223,72752,36457,36295
1293,금천구 독산3동,20224,72291,36209,36082
1294,금천구 독산3동,20231,71955,36069,35886
1295,금천구 독산3동,20232,71747,35921,35826
1296,금천구 독산3동,20233,71504,35842,35662
1297,금천구 독산3동,20234,71030,35603,35427
1298,금천구 독산3동,20241,70536,35380,35156
1299,금천구 독산3동,20242,70063,35221,34842
1300,금천구 독산4동,20221,45307,22693,22614
1301,금천구 독산4동,20222,45310,22790,22520
1302,금천구 독산4동,20223,45022,22637,22385
1303,금천구 독산4동,20224,44714,22477,22237
1304,금천구 독산4동,20231,44594,22406,22188
1305,금천구 독산4동,20232,44416,22315,22101
1306,금천구 독산4동,20233,44147,22129,22018
1307,금천구 독산4동,20234,43742,21915,21827
1308,금천구 독산4동,20241,43424,21747,21677
1309,금천구 독산4동,20242,43229,21659,21570
1310,금천구 시흥1동,20221,98211,48805,49406
1311,금천구 시흥1동,20222,98177,48689,49488
1312,금천구 시흥1동,20223,98037,48692,49345
1313,금천구 시흥1동,20224,97442,48550,48892
1314,금천구 시흥1동,20231,97090,48383,48707
1315,금천구 시흥1동,20232,96955,48237,48718
1316,금천구 시흥1동,20233,96816,48122,48694
1317,금천구 시흥1동,20234,96447,47917,48530
1318,금천구 시흥1동,20241,96148,47756,48392
1319,금천구 시흥1동,20242,95610,47395,48215
1320,금천구 시흥2동,20221,63462,30502,32960
1321,금천구 시흥2동,20222,62969,30232,32737
1322,금천구 시흥2동,20223,62518,29917,32601
1323,금천구 시흥2동,20224,62256,29811,32445
1324,금천구 시흥2동,20231,62062,29661,32401
1325,금천구 시흥2동,20232,61899,29581,32318
1326,금천구 시흥2동,20233,61794,29528,32266
1327,금천구 시흥2동,20234,61743,29494,32249
1328,금천구 시흥2동,20241,61371,29385,31986
1329,금천구 시흥2동,20242,61107,29239,31868
1330,금천구 시흥3동,20221,32280,16029,16251
1331,금천구 시흥3동,20222,32192,15957,16235
1332,금천구 시흥3동,20223,32077,15865,16212
1333,금천구 시흥3동,20224,31728,15708,16020
1334,금천구 시흥3동,20231,31446,15567,15879
1335,금천구 시흥3동,20232,31238,15446,15792
1336,금천구 시흥3동,20233,30992,15317,15675
1337,금천구 시흥3동,20234,30727,15172,15555
1338,금천구 시흥3동,20241,30735,15211,15524
1339,금천구 시흥3동,20242,30668,15140,15528
1340,금천구 시흥4동,20221,60717,30031,30686
1341,금천구 시흥4동,20222,60834,30084,30750
1342,금천구 시흥4동,20223,60590,29998,30592
1343,금천구 시흥4동,20224,60054,29729,30325
1344,금천구 시흥4동,20231,59682,29534,30148
1345,금천구 시흥4동,20232,59360,29353,30007
1346,금천구 시흥4동,20233,58983,29183,29800
1347,금천구 시흥4동,20234,58426,28884,29542
1348,금천구 시흥4동,20241,57775,28581,29194
1349,금천구 시흥4동,20242,57310,28333,28977
1350,금천구 시흥5동,20221,57298,28670,28628
1351,금천구 시흥5동,20222,57158,28683,28475
1352,금천구 시흥5동,20223,56845,28565,28280
1353,금천구 시흥5동,20224,56280,28226,28054
1354,금천구 시흥5동,20231,55913,28057,27856
1355,금천구 시흥5동,20232,55468,27795,27673
1356,금천구 시흥5동,20233,54950,27513,27437
1357,금천구 시흥5동,20234,54634,27328,27306
1358,금천구 시흥5동,20241,54254,27064,27190
1359,금천구 시흥5동,20242,53840,26821,27019
1360,노원구 공릉1동,20221,110097,53548,56549
1361,노원구 공릉1동,20222,109953,53414,56539
1362,노원구 공릉1동,20223,109984,53459,56525
1363,노원구 공릉1동,20224,109532,53188,56344
1364,노원구 공릉1동,20231,109221,53030,56191
1365,노원구 공릉1동,20232,108816,52725,56091
1366,노원구 공릉1동,20233,108452,52533,55919
1367,노원구 공릉1동,20234,108016,52236,55780
1368,노원구 공릉1동,20241,107948,52182,55766
1369,노원구 공릉1동,20242,107750,52058,55692
1370,노원구 공릉2동,20221,124532,60698,63834
1371,노원구 공릉2동,20222,125473,61075,64398
1372,노원구 공릉2동,20223,125571,61157,64414
1373,노원구 공릉2동,20224,125519,61224,64295
1374,노원구 공릉2동,20231,125362,61162,64200
1375,노원구 공릉2동,20232,125260,60967,64293
1376,노원구 공릉2동,20233,124779,60688,64091
1377,노원구 공릉2동,20234,124689,60618,64071
1378,노원구 공릉2동,20241,124283,60442,63841
1379,노원구 공릉2동,20242,124322,60287,64035
1380,노원구 상계10동,20221,55804,25850,29954
1381,노원구 상계10동,20222,55455,25664,29791
1382,노원구 상계10동,20223,55341,25615,29726
1383,노원구 상계10동,20224,55231,25496,29735
1384,노원구 상계10동,20231,55018,25333,29685
1385,노원구 상계10동,20232,54854,25281,29573
1386,노원구 상계10동,20233,54646,25179,29467
1387,노원구 상계10동,20234,54694,25144,29550
1388,노원구 상계10동,20241,54398,24983,29415
1389,노원구 상계10동,20242,54230,24906,29324
1390,노원구 상계1동,20221,113840,55072,58768
1391,노원구 상계1동,20222,113550,54904,58646
1392,노원구 상계1동,20223,113517,54830,58687
1393,노원구 상계1동,20224,113181,54719,58462
1394,노원구 상계1동,20231,112795,54482,58313
1395,노원구 상계1동,20232,112151,54050,58101
1396,노원구 상계1동,20233,111527,53642,57885
1397,노원구 상계1동,20234,110727,53199,57528
1398,노원구 상계1동,20241,110279,52933,57346
1399,노원구 상계1동,20242,110020,52772,57248
1400,노원구 상계2동,20221,59752,29501,30251
1401,노원구 상계2동,20222,59442,29285,30157
1402,노원구 상계2동,20223,59045,29051,29994
1403,노원구 상계2동,20224,58555,28778,29777
1404,노원구 상계2동,20231,58409,28732,29677
1405,노원구 상계2동,20232,58251,28671,29580
1406,노원구 상계2동,20233,57831,28491,29340
1407,노원구 상계2동,20234,57398,28299,29099
1408,노원구 상계2동,20241,57264,28245,29019
1409,노원구 상계2동,20242,57085,28112,28973
1410,노원구 상계3.4동,20221,77992,38819,39173
1411,노원구 상계3.4동,20222,77428,38548,38880
1412,노원구 상계3.4동,20223,76745,38231,38514
1413,노원구 상계3.4동,20224,75913,37838,38075
1414,노원구 상계3.4동,20231,75364,37613,37751
1415,노원구 상계3.4동,20232,75073,37438,37635
1416,노원구 상계3.4동,20233,80482,40075,40407
1417,노원구 상계3.4동,20234,82467,41030,41437
1418,노원구 상계3.4동,20241,82273,40913,41360
1419,노원구 상계3.4동,20242,82061,40766,41295
1420,노원구 상계5동,20221,71567,34697,36870
1421,노원구 상계5동,20222,71188,34472,36716
1422,노원구 상계5동,20223,71060,34468,36592
1423,노원구 상계5동,20224,70864,34361,36503
1424,노원구 상계5동,20231,70479,34135,36344
1425,노원구 상계5동,20232,70065,33969,36096
1426,노원구 상계5동,20233,69449,33672,35777
1427,노원구 상계5동,20234,69124,33539,35585
1428,노원구 상계5동,20241,68860,33383,35477
1429,노원구 상계5동,20242,68527,33260,35267
1430,노원구 상계6.7동,20221,97503,45027,52476
1431,노원구 상계6.7동,20222,96956,44785,52171
1432,노원구 상계6.7동,20223,96491,44528,51963
1433,노원구 상계6.7동,20224,95842,44256,51586
1434,노원구 상계6.7동,20231,95714,44207,51507
1435,노원구 상계6.7동,20232,95460,44065,51395
1436,노원구 상계6.7동,20233,94853,43726,51127
1437,노원구 상계6.7동,20234,94348,43477,50871
1438,노원구 상계6.7동,20241,94037,43337,50700
1439,노원구 상계6.7동,20242,93676,43146,50530
1440,노원구 상계8동,20221,67356,32250,35106
1441,노원구 상계8동,20222,67244,32123,35121
1442,노원구 상계8동,20223,67220,32121,35099
1443,노원구 상계8동,20224,67009,31970,35039
1444,노원구 상계8동,20231,66654,31774,34880
1445,노원구 상계8동,20232,66263,31636,34627
1446,노원구 상계8동,20233,65680,31374,34306
1447,노원구 상계8동,20234,65655,31252,34403
1448,노원구 상계8동,20241,65140,30984,34156
1449,노원구 상계8동,20242,64971,30887,34084
1450,노원구 상계9동,20221,61028,28789,32239
1451,노원구 상계9동,20222,60673,28587,32086
1452,노원구 상계9동,20223,60384,28378,32006
1453,노원구 상계9동,20224,59971,28118,31853
1454,노원구 상계9동,20231,59760,27966,31794
1455,노원구 상계9동,20232,59552,27890,31662
1456,노원구 상계9동,20233,59214,27733,31481
1457,노원구 상계9동,20234,58995,27635,31360
1458,노원구 상계9동,20241,58767,27542,31225
1459,노원구 상계9동,20242,58471,27380,31091
1460,노원구 월계1동,20221,64655,33423,31232
1461,노원구 월계1동,20222,64118,33126,30992
1462,노원구 월계1동,20223,63393,32714,30679
1463,노원구 월계1동,20224,62826,32379,30447
1464,노원구 월계1동,20231,62666,32230,30436
1465,노원구 월계1동,20232,62463,32064,30399
1466,노원구 월계1동,20233,62168,31819,30349
1467,노원구 월계1동,20234,61762,31661,30101
1468,노원구 월계1동,20241,61459,31573,29886
1469,노원구 월계1동,20242,61248,31480,29768
1470,노원구 월계2동,20221,79411,38200,41211
1471,노원구 월계2동,20222,78836,37894,40942
1472,노원구 월계2동,20223,78242,37608,40634
1473,노원구 월계2동,20224,77890,37474,40416
1474,노원구 월계2동,20231,77789,37412,40377
1475,노원구 월계2동,20232,77575,37251,40324
1476,노원구 월계2동,20233,77014,36978,40036
1477,노원구 월계2동,20234,76634,36771,39863
1478,노원구 월계2동,20241,76320,36601,39719
1479,노원구 월계2동,20242,76230,36556,39674
1480,노원구 월계3동,20221,89216,42554,46662
1481,노원구 월계3동,20222,88749,42358,46391
1482,노원구 월계3동,20223,88358,42155,46203
1483,노원구 월계3동,20224,87752,41893,45859
1484,노원구 월계3동,20231,87329,41764,45565
1485,노원구 월계3동,20232,86976,41614,45362
1486,노원구 월계3동,20233,86511,41363,45148
1487,노원구 월계3동,20234,86209,41267,44942
1488,노원구 월계3동,20241,85773,41003,44770
1489,노원구 월계3동,20242,85584,40869,44715
1490,노원구 중계1동,20221,80067,38949,41118
1491,노원구 중계1동,20222,79549,38729,40820
1492,노원구 중계1동,20223,79426,38688,40738
1493,노원구 중계1동,20224,79467,38738,40729
1494,노원구 중계1동,20231,79332,38669,40663
1495,노원구 중계1동,20232,79205,38666,40539
1496,노원구 중계1동,20233,79001,38556,40445
1497,노원구 중계1동,20234,79030,38570,40460
1498,노원구 중계1동,20241,78948,38499,40449
1499,노원구 중계1동,20242,78775,38408,40367
1500,노원구 중계2.3동,20221,101962,46766,55196
1501,노원구 중계2.3동,20222,101452,46552,54900
1502,노원구 중계2.3동,20223,100882,46265,54617
1503,노원구 중계2.3동,20224,100227,45875,54352
1504,노원구 중계2.3동,20231,99622,45591,54031
1505,노원구 중계2.3동,20232,99025,45338,53687
1506,노원구 중계2.3동,20233,98301,44925,53376
1507,노원구 중계2.3동,20234,97655,44568,53087
1508,노원구 중계2.3동,20241,97095,44255,52840
1509,노원구 중계2.3동,20242,96531,43898,52633
1510,노원구 중계4동,20221,59535,28616,30919
1511,노원구 중계4동,20222,59082,28398,30684
1512,노원구 중계4동,20223,58828,28238,30590
1513,노원구 중계4동,20224,58573,28112,30461
1514,노원구 중계4동,20231,58328,27997,30331
1515,노원구 중계4동,20232,58150,27854,30296
1516,노원구 중계4동,20233,57601,27598,30003
1517,노원구 중계4동,20234,57443,27501,29942
1518,노원구 중계4동,20241,57370,27476,29894
1519,노원구 중계4동,20242,57151,27395,29756
1520,노원구 중계본동,20221,71617,34834,36783
1521,노원구 중계본동,20222,71158,34634,36524
1522,노원구 중계본동,20223,70752,34410,36342
1523,노원구 중계본동,20224,70388,34226,36162
1524,노원구 중계본동,20231,70004,34025,35979
1525,노원구 중계본동,20232,69440,33716,35724
1526,노원구 중계본동,20233,69263,33604,35659
1527,노원구 중계본동,20234,69224,33555,35669
1528,노원구 중계본동,20241,69054,33452,35602
1529,노원구 중계본동,20242,68615,33249,35366
1530,노원구 하계1동,20221,80305,38460,41845
1531,노원구 하계1동,20222,81071,38850,42221
1532,노원구 하계1동,20223,79902,38268,41634
1533,노원구 하계1동,20224,79805,38206,41599
1534,노원구 하계1동,20231,79760,38201,41559
1535,노원구 하계1동,20232,80387,38550,41837
1536,노원구 하계1동,20233,79122,37897,41225
1537,노원구 하계1동,20234,78702,37694,41008
1538,노원구 하계1동,20241,78323,37447,40876
1539,노원구 하계1동,20242,78799,37754,41045
1540,노원구 하계2동,20221,65579,31250,34329
1541,노원구 하계2동,20222,65214,31018,34196
1542,노원구 하계2동,20223,65013,30867,34146
1543,노원구 하계2동,20224,64856,30754,34102
1544,노원구 하계2동,20231,64564,30646,33918
1545,노원구 하계2동,20232,64213,30488,33725
1546,노원구 하계2동,20233,64097,30444,33653
1547,노원구 하계2동,20234,63970,30396,33574
1548,노원구 하계2동,20241,63807,30355,33452
1549,노원구 하계2동,20242,63390,30136,33254
1550,도봉구 도봉1동,20221,62948,31758,31190
1551,도봉구 도봉1동,20222,62500,31440,31060
1552,도봉구 도봉1동,20223,62062,31106,30956
1553,도봉구 도봉1동,20224,61457,30767,30690
1554,도봉구 도봉1동,20231,61262,30647,30615
1555,도봉구 도봉1동,20232,60877,30455,30422
1556,도봉구 도봉1동,20233,60476,30275,30201
1557,도봉구 도봉1동,20234,60272,30093,30179
1558,도봉구 도봉1동,20241,59868,29885,29983
1559,도봉구 도봉1동,20242,59594,29741,29853
1560,도봉구 도봉2동,20221,80133,39124,41009
1561,도봉구 도봉2동,20222,79628,38901,40727
1562,도봉구 도봉2동,20223,79029,38642,40387
1563,도봉구 도봉2동,20224,78709,38513,40196
1564,도봉구 도봉2동,20231,78389,38322,40067
1565,도봉구 도봉2동,20232,78129,38201,39928
1566,도봉구 도봉2동,20233,77726,37965,39761
1567,도봉구 도봉2동,20234,77887,38013,39874
1568,도봉구 도봉2동,20241,78099,38141,39958
1569,도봉구 도봉2동,20242,78276,38281,39995
1570,도봉구 방학1동,20221,85924,42697,43227
1571,도봉구 방학1동,20222,85588,42523,43065
1572,도봉구 방학1동,20223,85109,42265,42844
1573,도봉구 방학1동,20224,84694,42021,42673
1574,도봉구 방학1동,20231,84364,41847,42517
1575,도봉구 방학1동,20232,84006,41604,42402
1576,도봉구 방학1동,20233,83501,41331,42170
1577,도봉구 방학1동,20234,83245,41218,42027
1578,도봉구 방학1동,20241,82964,41039,41925
1579,도봉구 방학1동,20242,82461,40768,41693
1580,도봉구 방학2동,20221,58806,29712,29094
1581,도봉구 방학2동,20222,58315,29495,28820
1582,도봉구 방학2동,20223,57876,29267,28609
1583,도봉구 방학2동,20224,57586,29074,28512
1584,도봉구 방학2동,20231,57120,28856,28264
1585,도봉구 방학2동,20232,56656,28653,28003
1586,도봉구 방학2동,20233,56224,28432,27792
1587,도봉구 방학2동,20234,55771,28175,27596
1588,도봉구 방학2동,20241,55462,28007,27455
1589,도봉구 방학2동,20242,54958,27710,27248
1590,도봉구 방학3동,20221,80856,39226,41630
1591,도봉구 방학3동,20222,80372,38984,41388
1592,도봉구 방학3동,20223,79949,38760,41189
1593,도봉구 방학3동,20224,79387,38437,40950
1594,도봉구 방학3동,20231,79248,38367,40881
1595,도봉구 방학3동,20232,79023,38256,40767
1596,도봉구 방학3동,20233,78658,38071,40587
1597,도봉구 방학3동,20234,78351,37905,40446
1598,도봉구 방학3동,20241,78096,37753,40343
1599,도봉구 방학3동,20242,77895,37636,40259
1600,도봉구 쌍문1동,20221,64070,30817,33253
1601,도봉구 쌍문1동,20222,63685,30644,33041
1602,도봉구 쌍문1동,20223,63559,30532,33027
1603,도봉구 쌍문1동,20224,63038,30248,32790
1604,도봉구 쌍문1동,20231,62874,30152,32722
1605,도봉구 쌍문1동,20232,62664,29988,32676
1606,도봉구 쌍문1동,20233,62236,29747,32489
1607,도봉구 쌍문1동,20234,62004,29598,32406
1608,도봉구 쌍문1동,20241,61887,29501,32386
1609,도봉구 쌍문1동,20242,61929,29413,32516
1610,도봉구 쌍문2동,20221,56073,26770,29303
1611,도봉구 쌍문2동,20222,55968,26619,29349
1612,도봉구 쌍문2동,20223,55627,26474,29153
1613,도봉구 쌍문2동,20224,55124,26263,28861
1614,도봉구 쌍문2동,20231,54821,26123,28698
1615,도봉구 쌍문2동,20232,54573,26006,28567
1616,도봉구 쌍문2동,20233,54135,25763,28372
1617,도봉구 쌍문2동,20234,53764,25596,28168
1618,도봉구 쌍문2동,20241,53510,25481,28029
1619,도봉구 쌍문2동,20242,53389,25417,27972
1620,도봉구 쌍문3동,20221,50031,24198,25833
1621,도봉구 쌍문3동,20222,50591,24356,26235
1622,도봉구 쌍문3동,20223,50705,24430,26275
1623,도봉구 쌍문3동,20224,50446,24277,26169
1624,도봉구 쌍문3동,20231,50257,24165,26092
1625,도봉구 쌍문3동,20232,49966,24018,25948
1626,도봉구 쌍문3동,20233,49582,23798,25784
1627,도봉구 쌍문3동,20234,49427,23685,25742
1628,도봉구 쌍문3동,20241,49211,23580,25631
1629,도봉구 쌍문3동,20242,49090,23477,25613
1630,도봉구 쌍문4동,20221,55696,26292,29404
1631,도봉구 쌍문4동,20222,55337,26095,29242
1632,도봉구 쌍문4동,20223,55183,26016,29167
1633,도봉구 쌍문4동,20224,54947,25926,29021
1634,도봉구 쌍문4동,20231,54881,25938,28943
1635,도봉구 쌍문4동,20232,54685,25798,28887
1636,도봉구 쌍문4동,20233,54515,25711,28804
1637,도봉구 쌍문4동,20234,54252,25635,28617
1638,도봉구 쌍문4동,20241,54062,25532,28530
1639,도봉구 쌍문4동,20242,53910,25408,28502
1640,도봉구 창1동,20221,73893,35087,38806
1641,도봉구 창1동,20222,73496,34977,38519
1642,도봉구 창1동,20223,73214,34853,38361
1643,도봉구 창1동,20224,73133,34824,38309
1644,도봉구 창1동,20231,72916,34728,38188
1645,도봉구 창1동,20232,72661,34637,38024
1646,도봉구 창1동,20233,72417,34555,37862
1647,도봉구 창1동,20234,72173,34416,37757
1648,도봉구 창1동,20241,71970,34300,37670
1649,도봉구 창1동,20242,71845,34246,37599
1650,도봉구 창2동,20221,87104,42403,44701
1651,도봉구 창2동,20222,86663,42131,44532
1652,도봉구 창2동,20223,86391,41937,44454
1653,도봉구 창2동,20224,86056,41777,44279
1654,도봉구 창2동,20231,85734,41645,44089
1655,도봉구 창2동,20232,85353,41472,43881
1656,도봉구 창2동,20233,84970,41249,43721
1657,도봉구 창2동,20234,84600,41033,43567
1658,도봉구 창2동,20241,84351,40851,43500
1659,도봉구 창2동,20242,83823,40583,43240
1660,도봉구 창3동,20221,41432,20737,20695
1661,도봉구 창3동,20222,41236,20615,20621
1662,도봉구 창3동,20223,40961,20454,20507
1663,도봉구 창3동,20224,40734,20303,20431
1664,도봉구 창3동,20231,40396,20115,20281
1665,도봉구 창3동,20232,40143,19990,20153
1666,도봉구 창3동,20233,39962,19891,20071
1667,도봉구 창3동,20234,39626,19721,19905
1668,도봉구 창3동,20241,39446,19654,19792
1669,도봉구 창3동,20242,39232,19548,19684
1670,도봉구 창4동,20221,79343,38152,41191
1671,도봉구 창4동,20222,78929,37944,40985
1672,도봉구 창4동,20223,78634,37806,40828
1673,도봉구 창4동,20224,78082,37480,40602
1674,도봉구 창4동,20231,77807,37306,40501
1675,도봉구 창4동,20232,77747,37277,40470
1676,도봉구 창4동,20233,77938,37311,40627
1677,도봉구 창4동,20234,78406,37525,40881
1678,도봉구 창4동,20241,79096,37755,41341
1679,도봉구 창4동,20242,79237,37760,41477
1680,도봉구 창5동,20221,73570,35115,38455
1681,도봉구 창5동,20222,73167,34987,38180
1682,도봉구 창5동,20223,72986,34909,38077
1683,도봉구 창5동,20224,72781,34861,37920
1684,도봉구 창5동,20231,72553,34727,37826
1685,도봉구 창5동,20232,72148,34498,37650
1686,도봉구 창5동,20233,71815,34308,37507
1687,도봉구 창5동,20234,71710,34222,37488
1688,도봉구 창5동,20241,71588,34102,37486
1689,도봉구 창5동,20242,71476,34046,37430
1690,동대문구 답십리1동,20221,86944,41910,45034
1691,동대문구 답십리1동,20222,86690,41721,44969
1692,동대문구 답십리1동,20223,86120,41442,44678
1693,동대문구 답십리1동,20224,84736,40805,43931
1694,동대문구 답십리1동,20231,84339,40618,43721
1695,동대문구 답십리1동,20232,84137,40525,43612
1696,동대문구 답십리1동,20233,83946,40377,43569
1697,동대문구 답십리1동,20234,83631,40201,43430
1698,동대문구 답십리1동,20241,83441,39993,43448
1699,동대문구 답십리1동,20242,83324,39872,43452
1700,동대문구 답십리2동,20221,84527,41122,43405
1701,동대문구 답십리2동,20222,84061,40792,43269
1702,동대문구 답십리2동,20223,83876,40647,43229
1703,동대문구 답십리2동,20224,83484,40411,43073
1704,동대문구 답십리2동,20231,83209,40226,42983
1705,동대문구 답십리2동,20232,83040,40156,42884
1706,동대문구 답십리2동,20233,82712,39979,42733
1707,동대문구 답십리2동,20234,82539,39823,42716
1708,동대문구 답십리2동,20241,82263,39591,42672
1709,동대문구 답십리2동,20242,82036,39421,42615
1710,동대문구 용신동,20221,96978,48591,48387
1711,동대문구 용신동,20222,97944,48915,49029
1712,동대문구 용신동,20223,99204,49523,49681
1713,동대문구 용신동,20224,103546,51583,51963
1714,동대문구 용신동,20231,104764,52073,52691
1715,동대문구 용신동,20232,107326,53128,54198
1716,동대문구 용신동,20233,113861,56338,57523
1717,동대문구 용신동,20234,115258,56940,58318
1718,동대문구 용신동,20241,115566,57073,58493
1719,동대문구 용신동,20242,115903,57171,58732
1720,동대문구 이문1동,20221,54221,27052,27169
1721,동대문구 이문1동,20222,54468,27112,27356
1722,동대문구 이문1동,20223,54603,27171,27432
1723,동대문구 이문1동,20224,54327,26922,27405
1724,동대문구 이문1동,20231,53936,26757,27179
1725,동대문구 이문1동,20232,53763,26629,27134
1726,동대문구 이문1동,20233,53602,26509,27093
1727,동대문구 이문1동,20234,53418,26375,27043
1728,동대문구 이문1동,20241,53428,26346,27082
1729,동대문구 이문1동,20242,53340,26238,27102
1730,동대문구 이문2동,20221,59888,28906,30982
1731,동대문구 이문2동,20222,59535,28735,30800
1732,동대문구 이문2동,20223,59314,28603,30711
1733,동대문구 이문2동,20224,59035,28454,30581
1734,동대문구 이문2동,20231,58854,28347,30507
1735,동대문구 이문2동,20232,58634,28156,30478
1736,동대문구 이문2동,20233,58503,28082,30421
1737,동대문구 이문2동,20234,58301,28019,30282
1738,동대문구 이문2동,20241,58001,27893,30108
1739,동대문구 이문2동,20242,57658,27707,29951
1740,동대문구 장안1동,20221,114575,56688,57887
1741,동대문구 장안1동,20222,114441,56607,57834
1742,동대문구 장안1동,20223,114262,56519,57743
1743,동대문구 장안1동,20224,114206,56475,57731
1744,동대문구 장안1동,20231,114029,56324,57705
1745,동대문구 장안1동,20232,113470,56032,57438
1746,동대문구 장안1동,20233,112790,55661,57129
1747,동대문구 장안1동,20234,112334,55445,56889
1748,동대문구 장안1동,20241,112273,55432,56841
1749,동대문구 장안1동,20242,112228,55316,56912
1750,동대문구 장안2동,20221,97430,48583,48847
1751,동대문구 장안2동,20222,97254,48378,48876
1752,동대문구 장안2동,20223,97366,48328,49038
1753,동대문구 장안2동,20224,97173,48244,48929
1754,동대문구 장안2동,20231,97089,48203,48886
1755,동대문구 장안2동,20232,97401,48267,49134
1756,동대문구 장안2동,20233,97632,48353,49279
1757,동대문구 장안2동,20234,97944,48524,49420
1758,동대문구 장안2동,20241,98024,48514,49510
1759,동대문구 장안2동,20242,97870,48327,49543
1760,동대문구 전농1동,20221,87312,43759,43553
1761,동대문구 전농1동,20222,86897,43542,43355
1762,동대문구 전농1동,20223,86471,43222,43249
1763,동대문구 전농1동,20224,86064,42943,43121
1764,동대문구 전농1동,20231,86154,42884,43270
1765,동대문구 전농1동,20232,86047,42779,43268
1766,동대문구 전농1동,20233,89542,44563,44979
1767,동대문구 전농1동,20234,95960,47718,48242
1768,동대문구 전농1동,20241,97840,48684,49156
1769,동대문구 전농1동,20242,98841,49188,49653
1770,동대문구 전농2동,20221,55411,26645,28766
1771,동대문구 전농2동,20222,55156,26490,28666
1772,동대문구 전농2동,20223,54967,26341,28626
1773,동대문구 전농2동,20224,54705,26206,28499
1774,동대문구 전농2동,20231,54378,26058,28320
1775,동대문구 전농2동,20232,54354,26027,28327
1776,동대문구 전농2동,20233,54260,25917,28343
1777,동대문구 전농2동,20234,53936,25700,28236
1778,동대문구 전농2동,20241,53572,25480,28092
1779,동대문구 전농2동,20242,53463,25389,28074
1780,동대문구 제기동,20221,73828,37864,35964
1781,동대문구 제기동,20222,73631,37735,35896
1782,동대문구 제기동,20223,73299,37491,35808
1783,동대문구 제기동,20224,72745,37186,35559
1784,동대문구 제기동,20231,72436,37079,35357
1785,동대문구 제기동,20232,72190,36944,35246
1786,동대문구 제기동,20233,70802,36201,34601
1787,동대문구 제기동,20234,69349,35556,33793
1788,동대문구 제기동,20241,68887,35330,33557
1789,동대문구 제기동,20242,68824,35266,33558
1790,동대문구 청량리동,20221,56321,28010,28311
1791,동대문구 청량리동,20222,56100,27980,28120
1792,동대문구 청량리동,20223,55961,27904,28057
1793,동대문구 청량리동,20224,55852,27858,27994
1794,동대문구 청량리동,20231,55866,27842,28024
1795,동대문구 청량리동,20232,56476,27994,28482
1796,동대문구 청량리동,20233,56583,27969,28614
1797,동대문구 청량리동,20234,56267,27767,28500
1798,동대문구 청량리동,20241,56079,27608,28471
1799,동대문구 청량리동,20242,56057,27582,28475
1800,동대문구 회기동,20221,31545,15107,16438
1801,동대문구 회기동,20222,31797,15261,16536
1802,동대문구 회기동,20223,31918,15332,16586
1803,동대문구 회기동,20224,31759,15246,16513
1804,동대문구 회기동,20231,31586,15137,16449
1805,동대문구 회기동,20232,31485,14962,16523
1806,동대문구 회기동,20233,31303,14821,16482
1807,동대문구 회기동,20234,31283,14766,16517
1808,동대문구 회기동,20241,31146,14729,16417
1809,동대문구 회기동,20242,31216,14768,16448
1810,동대문구 휘경1동,20221,41972,19941,22031
1811,동대문구 휘경1동,20222,42044,19915,22129
1812,동대문구 휘경1동,20223,42154,19964,22190
1813,동대문구 휘경1동,20224,41869,19790,22079
1814,동대문구 휘경1동,20231,41954,19752,22202
1815,동대문구 휘경1동,20232,41809,19707,22102
1816,동대문구 휘경1동,20233,41600,19635,21965
1817,동대문구 휘경1동,20234,41195,19424,21771
1818,동대문구 휘경1동,20241,41246,19379,21867
1819,동대문구 휘경1동,20242,41299,19353,21946
1820,동대문구 휘경2동,20221,72330,36154,36176
1821,동대문구 휘경2동,20222,72325,36166,36159
1822,동대문구 휘경2동,20223,72022,35970,36052
1823,동대문구 휘경2동,20224,71657,35815,35842
1824,동대문구 휘경2동,20231,72688,36252,36436
1825,동대문구 휘경2동,20232,73355,36538,36817
1826,동대문구 휘경2동,20233,73092,36444,36648
1827,동대문구 휘경2동,20234,72765,36213,36552
1828,동대문구 휘경2동,20241,72824,36214,36610
1829,동대문구 휘경2동,20242,72947,36390,36557
1830,동작구 노량진1동,20221,95630,48030,47600
1831,동작구 노량진1동,20222,95753,48168,47585
1832,동작구 노량진1동,20223,95599,48153,47446
1833,동작구 노량진1동,20224,95070,47942,47128
1834,동작구 노량진1동,20231,95232,48127,47105
1835,동작구 노량진1동,20232,95796,48507,47289
1836,동작구 노량진1동,20233,96194,48807,47387
1837,동작구 노량진1동,20234,96072,48811,47261
1838,동작구 노량진1동,20241,96071,48807,47264
1839,동작구 노량진1동,20242,97647,49601,48046
1840,동작구 노량진2동,20221,32217,16646,15571
1841,동작구 노량진2동,20222,31946,16492,15454
1842,동작구 노량진2동,20223,31797,16457,15340
1843,동작구 노량진2동,20224,31592,16370,15222
1844,동작구 노량진2동,20231,31538,16417,15121
1845,동작구 노량진2동,20232,31500,16471,15029
1846,동작구 노량진2동,20233,31158,16309,14849
1847,동작구 노량진2동,20234,30747,16041,14706
1848,동작구 노량진2동,20241,29625,15531,14094
1849,동작구 노량진2동,20242,27208,14366,12842
1850,동작구 대방동,20221,113594,53843,59751
1851,동작구 대방동,20222,113232,53658,59574
1852,동작구 대방동,20223,112715,53413,59302
1853,동작구 대방동,20224,110953,52488,58465
1854,동작구 대방동,20231,108759,51385,57374
1855,동작구 대방동,20232,107525,50730,56795
1856,동작구 대방동,20233,107294,50568,56726
1857,동작구 대방동,20234,106980,50396,56584
1858,동작구 대방동,20241,107106,50434,56672
1859,동작구 대방동,20242,106872,50344,56528
1860,동작구 사당1동,20221,68408,32661,35747
1861,동작구 사당1동,20222,68349,32656,35693
1862,동작구 사당1동,20223,68196,32610,35586
1863,동작구 사당1동,20224,67746,32501,35245
1864,동작구 사당1동,20231,67710,32535,35175
1865,동작구 사당1동,20232,67569,32500,35069
1866,동작구 사당1동,20233,67562,32501,35061
1867,동작구 사당1동,20234,67572,32554,35018
1868,동작구 사당1동,20241,67575,32526,35049
1869,동작구 사당1동,20242,67498,32506,34992
1870,동작구 사당2동,20221,83777,40192,43585
1871,동작구 사당2동,20222,85271,40868,44403
1872,동작구 사당2동,20223,85517,40998,44519
1873,동작구 사당2동,20224,85337,40878,44459
1874,동작구 사당2동,20231,85152,40754,44398
1875,동작구 사당2동,20232,84979,40703,44276
1876,동작구 사당2동,20233,84732,40577,44155
1877,동작구 사당2동,20234,84472,40505,43967
1878,동작구 사당2동,20241,84278,40398,43880
1879,동작구 사당2동,20242,84318,40376,43942
1880,동작구 사당3동,20221,73006,35435,37571
1881,동작구 사당3동,20222,72778,35294,37484
1882,동작구 사당3동,20223,72354,35082,37272
1883,동작구 사당3동,20224,72050,34917,37133
1884,동작구 사당3동,20231,71808,34688,37120
1885,동작구 사당3동,20232,71805,34701,37104
1886,동작구 사당3동,20233,71610,34589,37021
1887,동작구 사당3동,20234,71147,34370,36777
1888,동작구 사당3동,20241,71004,34285,36719
1889,동작구 사당3동,20242,70919,34248,36671
1890,동작구 사당4동,20221,42462,20278,22184
1891,동작구 사당4동,20222,42460,20246,22214
1892,동작구 사당4동,20223,42327,20165,22162
1893,동작구 사당4동,20224,42106,20092,22014
1894,동작구 사당4동,20231,41935,20006,21929
1895,동작구 사당4동,20232,41691,19887,21804
1896,동작구 사당4동,20233,41671,19938,21733
1897,동작구 사당4동,20234,41509,19887,21622
1898,동작구 사당4동,20241,41387,19812,21575
1899,동작구 사당4동,20242,41322,19741,21581
1900,동작구 사당5동,20221,43362,20815,22547
1901,동작구 사당5동,20222,43163,20683,22480
1902,동작구 사당5동,20223,43045,20604,22441
1903,동작구 사당5동,20224,43010,20616,22394
1904,동작구 사당5동,20231,42913,20539,22374
1905,동작구 사당5동,20232,42778,20428,22350
1906,동작구 사당5동,20233,42627,20323,22304
1907,동작구 사당5동,20234,42438,20242,22196
1908,동작구 사당5동,20241,42392,20223,22169
1909,동작구 사당5동,20242,42290,20223,22067
1910,동작구 상도1동,20221,132649,64349,68300
1911,동작구 상도1동,20222,133200,64644,68556
1912,동작구 상도1동,20223,133186,64633,68553
1913,동작구 상도1동,20224,132810,64490,68320
1914,동작구 상도1동,20231,133004,64635,68369
1915,동작구 상도1동,20232,133093,64626,68467
1916,동작구 상도1동,20233,133169,64682,68487
1917,동작구 상도1동,20234,132970,64514,68456
1918,동작구 상도1동,20241,132656,64366,68290
1919,동작구 상도1동,20242,132804,64459,68345
1920,동작구 상도2동,20221,84012,40356,43656
1921,동작구 상도2동,20222,83711,40134,43577
1922,동작구 상도2동,20223,83408,39919,43489
1923,동작구 상도2동,20224,83109,39754,43355
1924,동작구 상도2동,20231,83086,39786,43300
1925,동작구 상도2동,20232,82972,39750,43222
1926,동작구 상도2동,20233,82768,39616,43152
1927,동작구 상도2동,20234,82569,39477,43092
1928,동작구 상도2동,20241,82393,39308,43085
1929,동작구 상도2동,20242,82272,39166,43106
1930,동작구 상도3동,20221,73249,34907,38342
1931,동작구 상도3동,20222,73067,34773,38294
1932,동작구 상도3동,20223,72979,34726,38253
1933,동작구 상도3동,20224,72472,34514,37958
1934,동작구 상도3동,20231,72482,34454,38028
1935,동작구 상도3동,20232,72371,34399,37972
1936,동작구 상도3동,20233,72121,34249,37872
1937,동작구 상도3동,20234,71821,34149,37672
1938,동작구 상도3동,20241,71765,34083,37682
1939,동작구 상도3동,20242,71637,34003,37634
1940,동작구 상도4동,20221,85782,41630,44152
1941,동작구 상도4동,20222,85511,41498,44013
1942,동작구 상도4동,20223,85167,41381,43786
1943,동작구 상도4동,20224,84757,41152,43605
1944,동작구 상도4동,20231,84602,41148,43454
1945,동작구 상도4동,20232,84211,40942,43269
1946,동작구 상도4동,20233,83668,40660,43008
1947,동작구 상도4동,20234,83288,40435,42853
1948,동작구 상도4동,20241,82978,40224,42754
1949,동작구 상도4동,20242,84636,40981,43655
1950,동작구 신대방1동,20221,69245,33238,36007
1951,동작구 신대방1동,20222,69099,33114,35985
1952,동작구 신대방1동,20223,69727,33354,36373
1953,동작구 신대방1동,20224,69979,33534,36445
1954,동작구 신대방1동,20231,70118,33613,36505
1955,동작구 신대방1동,20232,70120,33595,36525
1956,동작구 신대방1동,20233,70035,33577,36458
1957,동작구 신대방1동,20234,69915,33482,36433
1958,동작구 신대방1동,20241,69717,33423,36294
1959,동작구 신대방1동,20242,69731,33492,36239
1960,동작구 신대방2동,20221,65448,31285,34163
1961,동작구 신대방2동,20222,66350,31742,34608
1962,동작구 신대방2동,20223,66806,32048,34758
1963,동작구 신대방2동,20224,66804,32009,34795
1964,동작구 신대방2동,20231,66646,31822,34824
1965,동작구 신대방2동,20232,66443,31750,34693
1966,동작구 신대방2동,20233,66357,31734,34623
1967,동작구 신대방2동,20234,66166,31685,34481
1968,동작구 신대방2동,20241,66140,31731,34409
1969,동작구 신대방2동,20242,65920,31618,34302
1970,동작구 흑석동,20221,94144,45832,48312
1971,동작구 흑석동,20222,93745,45549,48196
1972,동작구 흑석동,20223,91939,44681,47258
1973,동작구 흑석동,20224,87252,42467,44785
1974,동작구 흑석동,20231,84817,41343,43474
1975,동작구 흑석동,20232,88748,43302,45446
1976,동작구 흑석동,20233,90228,43939,46289
1977,동작구 흑석동,20234,89929,43645,46284
1978,동작구 흑석동,20241,90205,43734,46471
1979,동작구 흑석동,20242,90673,43951,46722
1980,마포구 공덕동,20221,111454,52360,59094
1981,마포구 공덕동,20222,111180,52131,59049
1982,마포구 공덕동,20223,111082,52081,59001
1983,마포구 공덕동,20224,110575,51789,58786
1984,마포구 공덕동,20231,110313,51601,58712
1985,마포구 공덕동,20232,110238,51509,58729
1986,마포구 공덕동,20233,110012,51380,58632
1987,마포구 공덕동,20234,109617,51211,58406
1988,마포구 공덕동,20241,109347,50940,58407
1989,마포구 공덕동,20242,109074,50741,58333
1990,마포구 대흥동,20221,43570,21076,22494
1991,마포구 대흥동,20222,43623,21105,22518
1992,마포구 대흥동,20223,43771,21253,22518
1993,마포구 대흥동,20224,43593,21181,22412
1994,마포구 대흥동,20231,43483,21108,22375
1995,마포구 대흥동,20232,43389,21114,22275
1996,마포구 대흥동,20233,43450,21138,22312
1997,마포구 대흥동,20234,43324,21024,22300
1998,마포구 대흥동,20241,43224,20988,22236
1999,마포구 대흥동,20242,43230,20964,22266
2000,마포구 도화동,20221,63192,30132,33060
2001,마포구 도화동,20222,62961,30013,32948
2002,마포구 도화동,20223,62782,29905,32877
2003,마포구 도화동,20224,62618,29868,32750
2004,마포구 도화동,20231,62395,29745,32650
2005,마포구 도화동,20232,62036,29463,32573
2006,마포구 도화동,20233,61962,29418,32544
2007,마포구 도화동,20234,61888,29340,32548
2008,마포구 도화동,20241,61911,29353,32558
2009,마포구 도화동,20242,61926,29343,32583
2010,마포구 망원1동,20221,59934,28025,31909
2011,마포구 망원1동,20222,59394,27780,31614
2012,마포구 망원1동,20223,58958,27580,31378
2013,마포구 망원1동,20224,58411,27356,31055
2014,마포구 망원1동,20231,58128,27174,30954
2015,마포구 망원1동,20232,57928,26996,30932
2016,마포구 망원1동,20233,57747,26858,30889
2017,마포구 망원1동,20234,57499,26739,30760
2018,마포구 망원1동,20241,57391,26673,30718
2019,마포구 망원1동,20242,56980,26383,30597
2020,마포구 망원2동,20221,55601,26056,29545
2021,마포구 망원2동,20222,55532,25964,29568
2022,마포구 망원2동,20223,55338,25853,29485
2023,마포구 망원2동,20224,54926,25661,29265
2024,마포구 망원2동,20231,54632,25530,29102
2025,마포구 망원2동,20232,54430,25380,29050
2026,마포구 망원2동,20233,54135,25184,28951
2027,마포구 망원2동,20234,53887,25093,28794
2028,마포구 망원2동,20241,53455,24838,28617
2029,마포구 망원2동,20242,53115,24688,28427
2030,마포구 상암동,20221,92056,43648,48408
2031,마포구 상암동,20222,91480,43403,48077
2032,마포구 상암동,20223,91225,43181,48044
2033,마포구 상암동,20224,90678,42789,47889
2034,마포구 상암동,20231,90063,42498,47565
2035,마포구 상암동,20232,89894,42335,47559
2036,마포구 상암동,20233,89492,42092,47400
2037,마포구 상암동,20234,89090,41856,47234
2038,마포구 상암동,20241,88987,41784,47203
2039,마포구 상암동,20242,88851,41654,47197
2040,마포구 서강동,20221,74831,35685,39146
2041,마포구 서강동,20222,74669,35658,39011
2042,마포구 서강동,20223,74627,35625,39002
2043,마포구 서강동,20224,74219,35422,38797
2044,마포구 서강동,20231,74068,35360,38708
2045,마포구 서강동,20232,73933,35212,38721
2046,마포구 서강동,20233,73713,35133,38580
2047,마포구 서강동,20234,73676,35108,38568
2048,마포구 서강동,20241,73816,35197,38619
2049,마포구 서강동,20242,73928,35269,38659
2050,마포구 서교동,20221,74516,34114,40402
2051,마포구 서교동,20222,74708,34138,40570
2052,마포구 서교동,20223,74415,34007,40408
2053,마포구 서교동,20224,73645,33626,40019
2054,마포구 서교동,20231,73382,33386,39996
2055,마포구 서교동,20232,73000,33182,39818
2056,마포구 서교동,20233,72483,33056,39427
2057,마포구 서교동,20234,72200,33011,39189
2058,마포구 서교동,20241,72130,33022,39108
2059,마포구 서교동,20242,71993,32931,39062
2060,마포구 성산1동,20221,56706,26717,29989
2061,마포구 성산1동,20222,56723,26671,30052
2062,마포구 성산1동,20223,56542,26509,30033
2063,마포구 성산1동,20224,56202,26341,29861
2064,마포구 성산1동,20231,56007,26239,29768
2065,마포구 성산1동,20232,55914,26141,29773
2066,마포구 성산1동,20233,55819,26089,29730
2067,마포구 성산1동,20234,55704,25953,29751
2068,마포구 성산1동,20241,55623,25884,29739
2069,마포구 성산1동,20242,55424,25732,29692
2070,마포구 성산2동,20221,118720,53509,65211
2071,마포구 성산2동,20222,118485,53211,65274
2072,마포구 성산2동,20223,118414,52990,65424
2073,마포구 성산2동,20224,117780,52675,65105
2074,마포구 성산2동,20231,117308,52330,64978
2075,마포구 성산2동,20232,116948,52115,64833
2076,마포구 성산2동,20233,116538,51857,64681
2077,마포구 성산2동,20234,116178,51654,64524
2078,마포구 성산2동,20241,116207,51558,64649
2079,마포구 성산2동,20242,116096,51420,64676
2080,마포구 신수동,20221,67512,32867,34645
2081,마포구 신수동,20222,67332,32796,34536
2082,마포구 신수동,20223,67228,32778,34450
2083,마포구 신수동,20224,66918,32626,34292
2084,마포구 신수동,20231,66729,32573,34156
2085,마포구 신수동,20232,66557,32445,34112
2086,마포구 신수동,20233,66499,32425,34074
2087,마포구 신수동,20234,66367,32372,33995
2088,마포구 신수동,20241,66370,32362,34008
2089,마포구 신수동,20242,66529,32416,34113
2090,마포구 아현동,20221,75428,35373,40055
2091,마포구 아현동,20222,75515,35336,40179
2092,마포구 아현동,20223,75530,35345,40185
2093,마포구 아현동,20224,75846,35436,40410
2094,마포구 아현동,20231,81744,38188,43556
2095,마포구 아현동,20232,84260,39422,44838
2096,마포구 아현동,20233,85191,39719,45472
2097,마포구 아현동,20234,85951,39989,45962
2098,마포구 아현동,20241,86824,40378,46446
2099,마포구 아현동,20242,86946,40409,46537
2100,마포구 연남동,20221,44701,21120,23581
2101,마포구 연남동,20222,44580,21075,23505
2102,마포구 연남동,20223,44217,20934,23283
2103,마포구 연남동,20224,43872,20812,23060
2104,마포구 연남동,20231,43591,20650,22941
2105,마포구 연남동,20232,43265,20447,22818
2106,마포구 연남동,20233,42965,20251,22714
2107,마포구 연남동,20234,42767,20147,22620
2108,마포구 연남동,20241,42566,19967,22599
2109,마포구 연남동,20242,42594,19934,22660
2110,마포구 염리동,20221,50519,24268,26251
2111,마포구 염리동,20222,50647,24291,26356
2112,마포구 염리동,20223,50693,24253,26440
2113,마포구 염리동,20224,50235,24000,26235
2114,마포구 염리동,20231,50323,24070,26253
2115,마포구 염리동,20232,50385,24067,26318
2116,마포구 염리동,20233,50470,24069,26401
2117,마포구 염리동,20234,50533,24103,26430
2118,마포구 염리동,20241,50640,24046,26594
2119,마포구 염리동,20242,50619,24047,26572
2120,마포구 용강동,20221,64843,30670,34173
2121,마포구 용강동,20222,64256,30400,33856
2122,마포구 용강동,20223,64127,30356,33771
2123,마포구 용강동,20224,63996,30279,33717
2124,마포구 용강동,20231,63849,30159,33690
2125,마포구 용강동,20232,63851,30131,33720
2126,마포구 용강동,20233,63893,30134,33759
2127,마포구 용강동,20234,63754,30053,33701
2128,마포구 용강동,20241,63741,30034,33707
2129,마포구 용강동,20242,63905,30066,33839
2130,마포구 합정동,20221,51925,24058,27867
2131,마포구 합정동,20222,51586,23895,27691
2132,마포구 합정동,20223,50980,23563,27417
2133,마포구 합정동,20224,50196,23159,27037
2134,마포구 합정동,20231,49940,23002,26938
2135,마포구 합정동,20232,49653,22834,26819
2136,마포구 합정동,20233,49439,22682,26757
2137,마포구 합정동,20234,49077,22589,26488
2138,마포구 합정동,20241,48707,22431,26276
2139,마포구 합정동,20242,48436,22249,26187
2140,서대문구 남가좌1동,20221,46192,22115,24077
2141,서대문구 남가좌1동,20222,46044,22023,24021
2142,서대문구 남가좌1동,20223,47866,22981,24885
2143,서대문구 남가좌1동,20224,49745,23875,25870
2144,서대문구 남가좌1동,20231,50160,24066,26094
2145,서대문구 남가좌1동,20232,50163,24023,26140
2146,서대문구 남가좌1동,20233,50182,24032,26150
2147,서대문구 남가좌1동,20234,50105,23982,26123
2148,서대문구 남가좌1동,20241,50056,23975,26081
2149,서대문구 남가좌1동,20242,50047,23960,26087
2150,서대문구 남가좌2동,20221,89183,43042,46141
2151,서대문구 남가좌2동,20222,88829,42801,46028
2152,서대문구 남가좌2동,20223,88721,42744,45977
2153,서대문구 남가좌2동,20224,88189,42406,45783
2154,서대문구 남가좌2동,20231,87856,42340,45516
2155,서대문구 남가좌2동,20232,87782,42403,45379
2156,서대문구 남가좌2동,20233,87678,42313,45365
2157,서대문구 남가좌2동,20234,87384,42188,45196
2158,서대문구 남가좌2동,20241,86996,41870,45126
2159,서대문구 남가좌2동,20242,87076,41815,45261
2160,서대문구 북가좌1동,20221,53759,25876,27883
2161,서대문구 북가좌1동,20222,53576,25728,27848
2162,서대문구 북가좌1동,20223,53516,25683,27833
2163,서대문구 북가좌1동,20224,53167,25479,27688
2164,서대문구 북가좌1동,20231,53127,25434,27693
2165,서대문구 북가좌1동,20232,53115,25434,27681
2166,서대문구 북가좌1동,20233,52872,25309,27563
2167,서대문구 북가좌1동,20234,52758,25221,27537
2168,서대문구 북가좌1동,20241,52486,25068,27418
2169,서대문구 북가좌1동,20242,52459,25045,27414
2170,서대문구 북가좌2동,20221,94363,46132,48231
2171,서대문구 북가좌2동,20222,93724,45740,47984
2172,서대문구 북가좌2동,20223,93203,45371,47832
2173,서대문구 북가좌2동,20224,92820,45207,47613
2174,서대문구 북가좌2동,20231,92729,45079,47650
2175,서대문구 북가좌2동,20232,92460,44961,47499
2176,서대문구 북가좌2동,20233,92359,44816,47543
2177,서대문구 북가좌2동,20234,92110,44627,47483
2178,서대문구 북가좌2동,20241,91860,44500,47360
2179,서대문구 북가좌2동,20242,91365,44218,47147
2180,서대문구 북아현동,20221,47541,22821,24720
2181,서대문구 북아현동,20222,47384,22737,24647
2182,서대문구 북아현동,20223,47171,22627,24544
2183,서대문구 북아현동,20224,46836,22473,24363
2184,서대문구 북아현동,20231,46694,22358,24336
2185,서대문구 북아현동,20232,46664,22360,24304
2186,서대문구 북아현동,20233,46579,22332,24247
2187,서대문구 북아현동,20234,46324,22194,24130
2188,서대문구 북아현동,20241,46467,22205,24262
2189,서대문구 북아현동,20242,46505,22266,24239
2190,서대문구 신촌동,20221,59917,26503,33414
2191,서대문구 신촌동,20222,60829,26787,34042
2192,서대문구 신촌동,20223,60930,26726,34204
2193,서대문구 신촌동,20224,60988,26627,34361
2194,서대문구 신촌동,20231,60961,26625,34336
2195,서대문구 신촌동,20232,61121,26553,34568
2196,서대문구 신촌동,20233,61054,26499,34555
2197,서대문구 신촌동,20234,60928,26298,34630
2198,서대문구 신촌동,20241,61127,26151,34976
2199,서대문구 신촌동,20242,61576,26127,35449
2200,서대문구 연희동,20221,104540,50014,54526
2201,서대문구 연희동,20222,104350,49851,54499
2202,서대문구 연희동,20223,104238,49892,54346
2203,서대문구 연희동,20224,103496,49545,53951
2204,서대문구 연희동,20231,102985,49218,53767
2205,서대문구 연희동,20232,102784,49048,53736
2206,서대문구 연희동,20233,102549,48848,53701
2207,서대문구 연희동,20234,102154,48650,53504
2208,서대문구 연희동,20241,101787,48566,53221
2209,서대문구 연희동,20242,101802,48451,53351
2210,서대문구 천연동,20221,51122,24240,26882
2211,서대문구 천연동,20222,50874,24129,26745
2212,서대문구 천연동,20223,50715,24022,26693
2213,서대문구 천연동,20224,50515,23919,26596
2214,서대문구 천연동,20231,50219,23724,26495
2215,서대문구 천연동,20232,50111,23636,26475
2216,서대문구 천연동,20233,49954,23535,26419
2217,서대문구 천연동,20234,49770,23440,26330
2218,서대문구 천연동,20241,49569,23373,26196
2219,서대문구 천연동,20242,49637,23383,26254
2220,서대문구 충현동,20221,61001,29372,31629
2221,서대문구 충현동,20222,60641,29176,31465
2222,서대문구 충현동,20223,60338,28967,31371
2223,서대문구 충현동,20224,59755,28652,31103
2224,서대문구 충현동,20231,59528,28590,30938
2225,서대문구 충현동,20232,59409,28598,30811
2226,서대문구 충현동,20233,59217,28543,30674
2227,서대문구 충현동,20234,59016,28369,30647
2228,서대문구 충현동,20241,59088,28420,30668
2229,서대문구 충현동,20242,58911,28364,30547
2230,서대문구 홍은1동,20221,68067,32893,35174
2231,서대문구 홍은1동,20222,68127,32924,35203
2232,서대문구 홍은1동,20223,68233,33042,35191
2233,서대문구 홍은1동,20224,67914,32884,35030
2234,서대문구 홍은1동,20231,67387,32589,34798
2235,서대문구 홍은1동,20232,67236,32456,34780
2236,서대문구 홍은1동,20233,66927,32307,34620
2237,서대문구 홍은1동,20234,66588,32094,34494
2238,서대문구 홍은1동,20241,66425,31998,34427
2239,서대문구 홍은1동,20242,66333,31952,34381
2240,서대문구 홍은2동,20221,79267,38239,41028
2241,서대문구 홍은2동,20222,78875,37978,40897
2242,서대문구 홍은2동,20223,78397,37665,40732
2243,서대문구 홍은2동,20224,78689,37736,40953
2244,서대문구 홍은2동,20231,84973,40816,44157
2245,서대문구 홍은2동,20232,86255,41428,44827
2246,서대문구 홍은2동,20233,86126,41317,44809
2247,서대문구 홍은2동,20234,85710,41108,44602
2248,서대문구 홍은2동,20241,85490,40965,44525
2249,서대문구 홍은2동,20242,85225,40746,44479
2250,서대문구 홍제1동,20221,70588,33056,37532
2251,서대문구 홍제1동,20222,70256,32864,37392
2252,서대문구 홍제1동,20223,70052,32764,37288
2253,서대문구 홍제1동,20224,71601,33434,38167
2254,서대문구 홍제1동,20231,74225,34664,39561
2255,서대문구 홍제1동,20232,74563,34837,39726
2256,서대문구 홍제1동,20233,74582,34874,39708
2257,서대문구 홍제1동,20234,74207,34696,39511
2258,서대문구 홍제1동,20241,73956,34566,39390
2259,서대문구 홍제1동,20242,73901,34564,39337
2260,서대문구 홍제2동,20221,40867,19235,21632
2261,서대문구 홍제2동,20222,40608,19048,21560
2262,서대문구 홍제2동,20223,40588,19000,21588
2263,서대문구 홍제2동,20224,40152,18771,21381
2264,서대문구 홍제2동,20231,39917,18685,21232
2265,서대문구 홍제2동,20232,39736,18560,21176
2266,서대문구 홍제2동,20233,39654,18534,21120
2267,서대문구 홍제2동,20234,39569,18509,21060
2268,서대문구 홍제2동,20241,39542,18544,20998
2269,서대문구 홍제2동,20242,39426,18480,20946
2270,서대문구 홍제3동,20221,50365,24224,26141
2271,서대문구 홍제3동,20222,52842,25397,27445
2272,서대문구 홍제3동,20223,53150,25549,27601
2273,서대문구 홍제3동,20224,53124,25537,27587
2274,서대문구 홍제3동,20231,53147,25509,27638
2275,서대문구 홍제3동,20232,53269,25529,27740
2276,서대문구 홍제3동,20233,53250,25561,27689
2277,서대문구 홍제3동,20234,53129,25463,27666
2278,서대문구 홍제3동,20241,52903,25302,27601
2279,서대문구 홍제3동,20242,52802,25284,27518
2280,서초구 내곡동,20221,52421,25347,27074
2281,서초구 내곡동,20222,52431,25368,27063
2282,서초구 내곡동,20223,52518,25400,27118
2283,서초구 내곡동,20224,52267,25284,26983
2284,서초구 내곡동,20231,52016,25164,26852
2285,서초구 내곡동,20232,52005,25130,26875
2286,서초구 내곡동,20233,51874,25090,26784
2287,서초구 내곡동,20234,51688,25022,26666
2288,서초구 내곡동,20241,51494,24923,26571
2289,서초구 내곡동,20242,51023,24622,26401
2290,서초구 반포1동,20221,103612,50350,53262
2291,서초구 반포1동,20222,103290,50161,53129
2292,서초구 반포1동,20223,103058,50184,52874
2293,서초구 반포1동,20224,102410,49899,52511
2294,서초구 반포1동,20231,102281,49863,52418
2295,서초구 반포1동,20232,102516,50038,52478
2296,서초구 반포1동,20233,102210,49849,52361
2297,서초구 반포1동,20234,101535,49544,51991
2298,서초구 반포1동,20241,101562,49546,52016
2299,서초구 반포1동,20242,101442,49545,51897
2300,서초구 반포2동,20221,47241,22502,24739
2301,서초구 반포2동,20222,47244,22480,24764
2302,서초구 반포2동,20223,47186,22450,24736
2303,서초구 반포2동,20224,46990,22357,24633
2304,서초구 반포2동,20231,46902,22253,24649
2305,서초구 반포2동,20232,46912,22233,24679
2306,서초구 반포2동,20233,50090,23753,26337
2307,서초구 반포2동,20234,67089,31814,35275
2308,서초구 반포2동,20241,71911,34089,37822
2309,서초구 반포2동,20242,73018,34583,38435
2310,서초구 반포3동,20221,66404,31574,34830
2311,서초구 반포3동,20222,65841,31322,34519
2312,서초구 반포3동,20223,65420,31138,34282
2313,서초구 반포3동,20224,67616,32234,35382
2314,서초구 반포3동,20231,70450,33600,36850
2315,서초구 반포3동,20232,71391,33988,37403
2316,서초구 반포3동,20233,71711,34126,37585
2317,서초구 반포3동,20234,71401,33925,37476
2318,서초구 반포3동,20241,71455,33892,37563
2319,서초구 반포3동,20242,71481,33915,37566
2320,서초구 반포4동,20221,57463,26920,30543
2321,서초구 반포4동,20222,57308,26905,30403
2322,서초구 반포4동,20223,56962,26755,30207
2323,서초구 반포4동,20224,56429,26500,29929
2324,서초구 반포4동,20231,56299,26457,29842
2325,서초구 반포4동,20232,56125,26341,29784
2326,서초구 반포4동,20233,55968,26271,29697
2327,서초구 반포4동,20234,55465,25991,29474
2328,서초구 반포4동,20241,55621,26066,29555
2329,서초구 반포4동,20242,55659,26011,29648
2330,서초구 반포본동,20221,3169,1487,1682
2331,서초구 반포본동,20222,1397,644,753
2332,서초구 반포본동,20223,961,455,506
2333,서초구 반포본동,20224,836,402,434
2334,서초구 반포본동,20231,804,387,417
2335,서초구 반포본동,20232,801,383,418
2336,서초구 반포본동,20233,753,350,403
2337,서초구 반포본동,20234,692,311,381
2338,서초구 반포본동,20241,665,296,369
2339,서초구 반포본동,20242,676,302,374
2340,서초구 방배1동,20221,50485,23632,26853
2341,서초구 방배1동,20222,50410,23642,26768
2342,서초구 방배1동,20223,50459,23669,26790
2343,서초구 방배1동,20224,50181,23487,26694
2344,서초구 방배1동,20231,50074,23392,26682
2345,서초구 방배1동,20232,49922,23276,26646
2346,서초구 방배1동,20233,49806,23212,26594
2347,서초구 방배1동,20234,49564,23103,26461
2348,서초구 방배1동,20241,49422,23033,26389
2349,서초구 방배1동,20242,49267,22940,26327
2350,서초구 방배2동,20221,57283,26890,30393
2351,서초구 방배2동,20222,56110,26290,29820
2352,서초구 방배2동,20223,55608,26006,29602
2353,서초구 방배2동,20224,55403,25877,29526
2354,서초구 방배2동,20231,55158,25794,29364
2355,서초구 방배2동,20232,54721,25568,29153
2356,서초구 방배2동,20233,54396,25394,29002
2357,서초구 방배2동,20234,54167,25318,28849
2358,서초구 방배2동,20241,54114,25210,28904
2359,서초구 방배2동,20242,53976,25101,28875
2360,서초구 방배3동,20221,56246,27171,29075
2361,서초구 방배3동,20222,55494,26791,28703
2362,서초구 방배3동,20223,53497,25761,27736
2363,서초구 방배3동,20224,51971,24996,26975
2364,서초구 방배3동,20231,51405,24691,26714
2365,서초구 방배3동,20232,51126,24521,26605
2366,서초구 방배3동,20233,50867,24358,26509
2367,서초구 방배3동,20234,49050,23411,25639
2368,서초구 방배3동,20241,47297,22488,24809
2369,서초구 방배3동,20242,47365,22546,24819
2370,서초구 방배4동,20221,70304,31997,38307
2371,서초구 방배4동,20222,69868,31872,37996
2372,서초구 방배4동,20223,69634,31698,37936
2373,서초구 방배4동,20224,69342,31600,37742
2374,서초구 방배4동,20231,69140,31535,37605
2375,서초구 방배4동,20232,68782,31327,37455
2376,서초구 방배4동,20233,68567,31108,37459
2377,서초구 방배4동,20234,68402,31026,37376
2378,서초구 방배4동,20241,68212,30881,37331
2379,서초구 방배4동,20242,68075,30826,37249
2380,서초구 방배본동,20221,62494,28866,33628
2381,서초구 방배본동,20222,62098,28633,33465
2382,서초구 방배본동,20223,62021,28640,33381
2383,서초구 방배본동,20224,61942,28629,33313
2384,서초구 방배본동,20231,61764,28503,33261
2385,서초구 방배본동,20232,61446,28310,33136
2386,서초구 방배본동,20233,61408,28368,33040
2387,서초구 방배본동,20234,61224,28233,32991
2388,서초구 방배본동,20241,61068,28170,32898
2389,서초구 방배본동,20242,60201,27796,32405
2390,서초구 서초1동,20221,61790,29767,32023
2391,서초구 서초1동,20222,61776,29800,31976
2392,서초구 서초1동,20223,61732,29841,31891
2393,서초구 서초1동,20224,61392,29706,31686
2394,서초구 서초1동,20231,61047,29437,31610
2395,서초구 서초1동,20232,60946,29353,31593
2396,서초구 서초1동,20233,61008,29428,31580
2397,서초구 서초1동,20234,60772,29419,31353
2398,서초구 서초1동,20241,60538,29198,31340
2399,서초구 서초1동,20242,60692,29187,31505
2400,서초구 서초2동,20221,79258,37816,41442
2401,서초구 서초2동,20222,79557,37994,41563
2402,서초구 서초2동,20223,79654,37921,41733
2403,서초구 서초2동,20224,79398,37791,41607
2404,서초구 서초2동,20231,79748,37813,41935
2405,서초구 서초2동,20232,80061,37920,42141
2406,서초구 서초2동,20233,79407,37502,41905
2407,서초구 서초2동,20234,75130,35460,39670
2408,서초구 서초2동,20241,74076,34914,39162
2409,서초구 서초2동,20242,74189,34977,39212
2410,서초구 서초3동,20221,97335,46649,50686
2411,서초구 서초3동,20222,96728,46194,50534
2412,서초구 서초3동,20223,96336,45881,50455
2413,서초구 서초3동,20224,96246,45781,50465
2414,서초구 서초3동,20231,96311,45717,50594
2415,서초구 서초3동,20232,96216,45679,50537
2416,서초구 서초3동,20233,96030,45652,50378
2417,서초구 서초3동,20234,95985,45622,50363
2418,서초구 서초3동,20241,96028,45575,50453
2419,서초구 서초3동,20242,96019,45524,50495
2420,서초구 서초4동,20221,92231,44986,47245
2421,서초구 서초4동,20222,91785,44787,46998
2422,서초구 서초4동,20223,91577,44733,46844
2423,서초구 서초4동,20224,90917,44422,46495
2424,서초구 서초4동,20231,90878,44394,46484
2425,서초구 서초4동,20232,90861,44369,46492
2426,서초구 서초4동,20233,91009,44446,46563
2427,서초구 서초4동,20234,90909,44388,46521
2428,서초구 서초4동,20241,90716,44298,46418
2429,서초구 서초4동,20242,90677,44224,46453
2430,서초구 양재1동,20221,128650,61409,67241
2431,서초구 양재1동,20222,128249,61268,66981
2432,서초구 양재1동,20223,127977,61092,66885
2433,서초구 양재1동,20224,127251,60715,66536
2434,서초구 양재1동,20231,127080,60486,66594
2435,서초구 양재1동,20232,126713,60171,66542
2436,서초구 양재1동,20233,126437,59958,66479
2437,서초구 양재1동,20234,126110,59839,66271
2438,서초구 양재1동,20241,125318,59432,65886
2439,서초구 양재1동,20242,124642,59088,65554
2440,서초구 양재2동,20221,65527,32732,32795
2441,서초구 양재2동,20222,65257,32655,32602
2442,서초구 양재2동,20223,65005,32575,32430
2443,서초구 양재2동,20224,64615,32357,32258
2444,서초구 양재2동,20231,64571,32437,32134
2445,서초구 양재2동,20232,64228,32205,32023
2446,서초구 양재2동,20233,64073,32072,32001
2447,서초구 양재2동,20234,63947,32060,31887
2448,서초구 양재2동,20241,63691,31829,31862
2449,서초구 양재2동,20242,63632,31743,31889
2450,서초구 잠원동,20221,80131,38533,41598
2451,서초구 잠원동,20222,79880,38458,41422
2452,서초구 잠원동,20223,79382,38225,41157
2453,서초구 잠원동,20224,78725,37920,40805
2454,서초구 잠원동,20231,78623,37853,40770
2455,서초구 잠원동,20232,78687,37845,40842
2456,서초구 잠원동,20233,80137,38558,41579
2457,서초구 잠원동,20234,80420,38715,41705
2458,서초구 잠원동,20241,80416,38739,41677
2459,서초구 잠원동,20242,80265,38676,41589
2460,성동구 금호1가동,20221,45530,21666,23864
2461,성동구 금호1가동,20222,45275,21569,23706
2462,성동구 금호1가동,20223,45124,21525,23599
2463,성동구 금호1가동,20224,45108,21548,23560
2464,성동구 금호1가동,20231,45012,21486,23526
2465,성동구 금호1가동,20232,44873,21376,23497
2466,성동구 금호1가동,20233,44645,21270,23375
2467,성동구 금호1가동,20234,44360,21142,23218
2468,성동구 금호1가동,20241,44167,21024,23143
2469,성동구 금호1가동,20242,44123,20982,23141
2470,성동구 금호2.3가동,20221,68000,32326,35674
2471,성동구 금호2.3가동,20222,67543,32089,35454
2472,성동구 금호2.3가동,20223,67336,32079,35257
2473,성동구 금호2.3가동,20224,66855,31934,34921
2474,성동구 금호2.3가동,20231,66595,31832,34763
2475,성동구 금호2.3가동,20232,66234,31674,34560
2476,성동구 금호2.3가동,20233,65994,31524,34470
2477,성동구 금호2.3가동,20234,65922,31407,34515
2478,성동구 금호2.3가동,20241,65674,31241,34433
2479,성동구 금호2.3가동,20242,65571,31134,34437
2480,성동구 금호4가동,20221,42898,20360,22538
2481,성동구 금호4가동,20222,42757,20256,22501
2482,성동구 금호4가동,20223,42567,20162,22405
2483,성동구 금호4가동,20224,42315,20032,22283
2484,성동구 금호4가동,20231,42560,20151,22409
2485,성동구 금호4가동,20232,42785,20271,22514
2486,성동구 금호4가동,20233,42782,20267,22515
2487,성동구 금호4가동,20234,42473,20119,22354
2488,성동구 금호4가동,20241,42356,20010,22346
2489,성동구 금호4가동,20242,42269,19924,22345
2490,성동구 마장동,20221,67021,33038,33983
2491,성동구 마장동,20222,66860,32940,33920
2492,성동구 마장동,20223,66719,32881,33838
2493,성동구 마장동,20224,66189,32651,33538
2494,성동구 마장동,20231,65985,32548,33437
2495,성동구 마장동,20232,65749,32443,33306
2496,성동구 마장동,20233,65298,32145,33153
2497,성동구 마장동,20234,64831,31925,32906
2498,성동구 마장동,20241,64585,31711,32874
2499,성동구 마장동,20242,64502,31633,32869
2500,성동구 사근동,20221,35737,18524,17213
2501,성동구 사근동,20222,36275,18813,17462
2502,성동구 사근동,20223,36385,18996,17389
2503,성동구 사근동,20224,36096,18900,17196
2504,성동구 사근동,20231,36055,18872,17183
2505,성동구 사근동,20232,36247,19005,17242
2506,성동구 사근동,20233,36034,18901,17133
2507,성동구 사근동,20234,35956,18865,17091
2508,성동구 사근동,20241,35917,18783,17134
2509,성동구 사근동,20242,36336,18989,17347
2510,성동구 성수1가1동,20221,49455,24684,24771
2511,성동구 성수1가1동,20222,49222,24541,24681
2512,성동구 성수1가1동,20223,48888,24291,24597
2513,성동구 성수1가1동,20224,48370,24006,24364
2514,성동구 성수1가1동,20231,47649,23674,23975
2515,성동구 성수1가1동,20232,46855,23308,23547
2516,성동구 성수1가1동,20233,46664,23226,23438
2517,성동구 성수1가1동,20234,46292,23016,23276
2518,성동구 성수1가1동,20241,46128,22933,23195
2519,성동구 성수1가1동,20242,46082,22905,23177
2520,성동구 성수1가2동,20221,37569,18432,19137
2521,성동구 성수1가2동,20222,37139,18231,18908
2522,성동구 성수1가2동,20223,36718,18019,18699
2523,성동구 성수1가2동,20224,36396,17846,18550
2524,성동구 성수1가2동,20231,36410,17778,18632
2525,성동구 성수1가2동,20232,36292,17737,18555
2526,성동구 성수1가2동,20233,36088,17664,18424
2527,성동구 성수1가2동,20234,35931,17570,18361
2528,성동구 성수1가2동,20241,35717,17429,18288
2529,성동구 성수1가2동,20242,35583,17341,18242
2530,성동구 성수2가1동,20221,47221,24675,22546
2531,성동구 성수2가1동,20222,46845,24487,22358
2532,성동구 성수2가1동,20223,46482,24271,22211
2533,성동구 성수2가1동,20224,45885,23926,21959
2534,성동구 성수2가1동,20231,45324,23616,21708
2535,성동구 성수2가1동,20232,44722,23215,21507
2536,성동구 성수2가1동,20233,44170,22912,21258
2537,성동구 성수2가1동,20234,43840,22704,21136
2538,성동구 성수2가1동,20241,43673,22626,21047
2539,성동구 성수2가1동,20242,43507,22533,20974
2540,성동구 성수2가3동,20221,32170,16177,15993
2541,성동구 성수2가3동,20222,32033,16080,15953
2542,성동구 성수2가3동,20223,31796,15899,15897
2543,성동구 성수2가3동,20224,31091,15482,15609
2544,성동구 성수2가3동,20231,30800,15351,15449
2545,성동구 성수2가3동,20232,30656,15327,15329
2546,성동구 성수2가3동,20233,30420,15182,15238
2547,성동구 성수2가3동,20234,30200,15072,15128
2548,성동구 성수2가3동,20241,30042,15019,15023
2549,성동구 성수2가3동,20242,29865,14946,14919
2550,성동구 송정동,20221,31487,16603,14884
2551,성동구 송정동,20222,31192,16457,14735
2552,성동구 송정동,20223,30720,16241,14479
2553,성동구 송정동,20224,30352,16041,14311
2554,성동구 송정동,20231,30077,15903,14174
2555,성동구 송정동,20232,29799,15742,14057
2556,성동구 송정동,20233,29548,15586,13962
2557,성동구 송정동,20234,29238,15328,13910
2558,성동구 송정동,20241,29053,15257,13796
2559,성동구 송정동,20242,28877,15146,13731
2560,성동구 옥수동,20221,77780,36213,41567
2561,성동구 옥수동,20222,77509,36042,41467
2562,성동구 옥수동,20223,77194,35844,41350
2563,성동구 옥수동,20224,76792,35681,41111
2564,성동구 옥수동,20231,76669,35579,41090
2565,성동구 옥수동,20232,76438,35444,40994
2566,성동구 옥수동,20233,76344,35395,40949
2567,성동구 옥수동,20234,76166,35293,40873
2568,성동구 옥수동,20241,76134,35285,40849
2569,성동구 옥수동,20242,76350,35297,41053
2570,성동구 왕십리2동,20221,49316,23809,25507
2571,성동구 왕십리2동,20222,49036,23709,25327
2572,성동구 왕십리2동,20223,48889,23609,25280
2573,성동구 왕십리2동,20224,48906,23571,25335
2574,성동구 왕십리2동,20231,48890,23540,25350
2575,성동구 왕십리2동,20232,48691,23430,25261
2576,성동구 왕십리2동,20233,48525,23349,25176
2577,성동구 왕십리2동,20234,48350,23254,25096
2578,성동구 왕십리2동,20241,48256,23217,25039
2579,성동구 왕십리2동,20242,48251,23179,25072
2580,성동구 왕십리도선동,20221,79374,37624,41750
2581,성동구 왕십리도선동,20222,79604,37684,41920
2582,성동구 왕십리도선동,20223,79686,37599,42087
2583,성동구 왕십리도선동,20224,79392,37412,41980
2584,성동구 왕십리도선동,20231,79209,37311,41898
2585,성동구 왕십리도선동,20232,79213,37273,41940
2586,성동구 왕십리도선동,20233,79119,37112,42007
2587,성동구 왕십리도선동,20234,78855,36971,41884
2588,성동구 왕십리도선동,20241,78906,36937,41969
2589,성동구 왕십리도선동,20242,78613,36872,41741
2590,성동구 용답동,20221,34758,18087,16671
2591,성동구 용답동,20222,34497,17942,16555
2592,성동구 용답동,20223,34759,18021,16738
2593,성동구 용답동,20224,34836,18001,16835
2594,성동구 용답동,20231,35131,18079,17052
2595,성동구 용답동,20232,35568,18255,17313
2596,성동구 용답동,20233,35738,18363,17375
2597,성동구 용답동,20234,36058,18561,17497
2598,성동구 용답동,20241,36183,18643,17540
2599,성동구 용답동,20242,36320,18721,17599
2600,성동구 응봉동,20221,46007,21934,24073
2601,성동구 응봉동,20222,45674,21772,23902
2602,성동구 응봉동,20223,45413,21676,23737
2603,성동구 응봉동,20224,45136,21514,23622
2604,성동구 응봉동,20231,44977,21379,23598
2605,성동구 응봉동,20232,44867,21328,23539
2606,성동구 응봉동,20233,44914,21331,23583
2607,성동구 응봉동,20234,44879,21298,23581
2608,성동구 응봉동,20241,44633,21170,23463
2609,성동구 응봉동,20242,44497,21092,23405
2610,성동구 행당1동,20221,41769,20072,21697
2611,성동구 행당1동,20222,41734,20043,21691
2612,성동구 행당1동,20223,41481,19937,21544
2613,성동구 행당1동,20224,41167,19796,21371
2614,성동구 행당1동,20231,41116,19772,21344
2615,성동구 행당1동,20232,41161,19767,21394
2616,성동구 행당1동,20233,41131,19734,21397
2617,성동구 행당1동,20234,41102,19703,21399
2618,성동구 행당1동,20241,41160,19706,21454
2619,성동구 행당1동,20242,41199,19668,21531
2620,성동구 행당2동,20221,69634,32624,37010
2621,성동구 행당2동,20222,69372,32461,36911
2622,성동구 행당2동,20223,69314,32397,36917
2623,성동구 행당2동,20224,69178,32268,36910
2624,성동구 행당2동,20231,68962,32165,36797
2625,성동구 행당2동,20232,68964,32118,36846
2626,성동구 행당2동,20233,68844,32090,36754
2627,성동구 행당2동,20234,68644,32030,36614
2628,성동구 행당2동,20241,68422,31909,36513
2629,성동구 행당2동,20242,68266,31834,36432
2630,성북구 길음1동,20221,105590,50110,55480
2631,성북구 길음1동,20222,104748,49674,55074
2632,성북구 길음1동,20223,104789,49633,55156
2633,성북구 길음1동,20224,104587,49523,55064
2634,성북구 길음1동,20231,104346,49412,54934
2635,성북구 길음1동,20232,104367,49359,55008
2636,성북구 길음1동,20233,104312,49276,55036
2637,성북구 길음1동,20234,104422,49348,55074
2638,성북구 길음1동,20241,104075,49204,54871
2639,성북구 길음1동,20242,104809,49541,55268
2640,성북구 길음2동,20221,56184,27022,29162
2641,성북구 길음2동,20222,63636,30651,32985
2642,성북구 길음2동,20223,64498,31013,33485
2643,성북구 길음2동,20224,64669,31092,33577
2644,성북구 길음2동,20231,64899,31168,33731
2645,성북구 길음2동,20232,65447,31383,34064
2646,성북구 길음2동,20233,65363,31266,34097
2647,성북구 길음2동,20234,65146,31112,34034
2648,성북구 길음2동,20241,64515,30832,33683
2649,성북구 길음2동,20242,64266,30678,33588
2650,성북구 돈암1동,20221,43847,20476,23371
2651,성북구 돈암1동,20222,43475,20304,23171
2652,성북구 돈암1동,20223,43333,20245,23088
2653,성북구 돈암1동,20224,43185,20176,23009
2654,성북구 돈암1동,20231,43188,20136,23052
2655,성북구 돈암1동,20232,43082,20065,23017
2656,성북구 돈암1동,20233,42956,20018,22938
2657,성북구 돈암1동,20234,42841,19970,22871
2658,성북구 돈암1동,20241,42656,19902,22754
2659,성북구 돈암1동,20242,42422,19823,22599
2660,성북구 돈암2동,20221,71304,33774,37530
2661,성북구 돈암2동,20222,70974,33582,37392
2662,성북구 돈암2동,20223,70863,33504,37359
2663,성북구 돈암2동,20224,70688,33393,37295
2664,성북구 돈암2동,20231,70514,33347,37167
2665,성북구 돈암2동,20232,70528,33341,37187
2666,성북구 돈암2동,20233,70500,33328,37172
2667,성북구 돈암2동,20234,70321,33252,37069
2668,성북구 돈암2동,20241,70284,33220,37064
2669,성북구 돈암2동,20242,70295,33175,37120
2670,성북구 동선동,20221,46348,19503,26845
2671,성북구 동선동,20222,46297,19411,26886
2672,성북구 동선동,20223,46340,19350,26990
2673,성북구 동선동,20224,45510,18963,26547
2674,성북구 동선동,20231,45161,18772,26389
2675,성북구 동선동,20232,45075,18633,26442
2676,성북구 동선동,20233,45026,18685,26341
2677,성북구 동선동,20234,45081,18655,26426
2678,성북구 동선동,20241,45074,18589,26485
2679,성북구 동선동,20242,45181,18488,26693
2680,성북구 보문동,20221,46194,22219,23975
2681,성북구 보문동,20222,48285,23242,25043
2682,성북구 보문동,20223,49165,23629,25536
2683,성북구 보문동,20224,49015,23509,25506
2684,성북구 보문동,20231,48910,23397,25513
2685,성북구 보문동,20232,48877,23386,25491
2686,성북구 보문동,20233,48839,23413,25426
2687,성북구 보문동,20234,48583,23290,25293
2688,성북구 보문동,20241,48506,23259,25247
2689,성북구 보문동,20242,48444,23168,25276
2690,성북구 삼선동,20221,68633,32715,35918
2691,성북구 삼선동,20222,68347,32502,35845
2692,성북구 삼선동,20223,67953,32252,35701
2693,성북구 삼선동,20224,67435,32010,35425
2694,성북구 삼선동,20231,67315,32038,35277
2695,성북구 삼선동,20232,67354,31972,35382
2696,성북구 삼선동,20233,66934,31793,35141
2697,성북구 삼선동,20234,66630,31616,35014
2698,성북구 삼선동,20241,66343,31459,34884
2699,성북구 삼선동,20242,66189,31424,34765
2700,성북구 석관동,20221,105037,51926,53111
2701,성북구 석관동,20222,104581,51701,52880
2702,성북구 석관동,20223,104175,51510,52665
2703,성북구 석관동,20224,103566,51155,52411
2704,성북구 석관동,20231,103122,50883,52239
2705,성북구 석관동,20232,102750,50706,52044
2706,성북구 석관동,20233,102280,50476,51804
2707,성북구 석관동,20234,101552,50170,51382
2708,성북구 석관동,20241,101316,49939,51377
2709,성북구 석관동,20242,101195,49806,51389
2710,성북구 성북동,20221,49508,23119,26389
2711,성북구 성북동,20222,49288,22970,26318
2712,성북구 성북동,20223,49155,22885,26270
2713,성북구 성북동,20224,48852,22728,26124
2714,성북구 성북동,20231,48684,22674,26010
2715,성북구 성북동,20232,48309,22447,25862
2716,성북구 성북동,20233,48019,22353,25666
2717,성북구 성북동,20234,47855,22246,25609
2718,성북구 성북동,20241,47774,22262,25512
2719,성북구 성북동,20242,47728,22273,25455
2720,성북구 안암동,20221,45158,22765,22393
2721,성북구 안암동,20222,45471,22926,22545
2722,성북구 안암동,20223,45366,22904,22462
2723,성북구 안암동,20224,45085,22740,22345
2724,성북구 안암동,20231,45193,22791,22402
2725,성북구 안암동,20232,45302,22822,22480
2726,성북구 안암동,20233,45140,22778,22362
2727,성북구 안암동,20234,44887,22675,22212
2728,성북구 안암동,20241,44921,22681,22240
2729,성북구 안암동,20242,45254,22927,22327
2730,성북구 월곡1동,20221,78793,37983,40810
2731,성북구 월곡1동,20222,78611,37873,40738
2732,성북구 월곡1동,20223,78249,37744,40505
2733,성북구 월곡1동,20224,77917,37586,40331
2734,성북구 월곡1동,20231,77831,37516,40315
2735,성북구 월곡1동,20232,77566,37417,40149
2736,성북구 월곡1동,20233,77187,37243,39944
2737,성북구 월곡1동,20234,76801,37022,39779
2738,성북구 월곡1동,20241,76591,36889,39702
2739,성북구 월곡1동,20242,76119,36611,39508
2740,성북구 월곡2동,20221,58263,28065,30198
2741,성북구 월곡2동,20222,58104,27939,30165
2742,성북구 월곡2동,20223,57926,27868,30058
2743,성북구 월곡2동,20224,57656,27706,29950
2744,성북구 월곡2동,20231,57530,27528,30002
2745,성북구 월곡2동,20232,57453,27393,30060
2746,성북구 월곡2동,20233,57235,27235,30000
2747,성북구 월곡2동,20234,56856,26991,29865
2748,성북구 월곡2동,20241,56584,26887,29697
2749,성북구 월곡2동,20242,56450,26796,29654
2750,성북구 장위1동,20221,72684,35555,37129
2751,성북구 장위1동,20222,72320,35401,36919
2752,성북구 장위1동,20223,72031,35273,36758
2753,성북구 장위1동,20224,71823,35095,36728
2754,성북구 장위1동,20231,71436,34789,36647
2755,성북구 장위1동,20232,71234,34626,36608
2756,성북구 장위1동,20233,70636,34258,36378
2757,성북구 장위1동,20234,70195,34051,36144
2758,성북구 장위1동,20241,69926,33928,35998
2759,성북구 장위1동,20242,69716,33821,35895
2760,성북구 장위2동,20221,41167,20326,20841
2761,성북구 장위2동,20222,41000,20209,20791
2762,성북구 장위2동,20223,40767,20008,20759
2763,성북구 장위2동,20224,40285,19799,20486
2764,성북구 장위2동,20231,40119,19723,20396
2765,성북구 장위2동,20232,39878,19551,20327
2766,성북구 장위2동,20233,39774,19492,20282
2767,성북구 장위2동,20234,39493,19333,20160
2768,성북구 장위2동,20241,39189,19192,19997
2769,성북구 장위2동,20242,38991,19073,19918
2770,성북구 장위3동,20221,47321,23257,24064
2771,성북구 장위3동,20222,47150,23102,24048
2772,성북구 장위3동,20223,46984,22988,23996
2773,성북구 장위3동,20224,47126,23025,24101
2774,성북구 장위3동,20231,47219,23111,24108
2775,성북구 장위3동,20232,47347,23222,24125
2776,성북구 장위3동,20233,47082,23067,24015
2777,성북구 장위3동,20234,46644,22873,23771
2778,성북구 장위3동,20241,46581,22829,23752
2779,성북구 장위3동,20242,46473,22785,23688
2780,성북구 정릉1동,20221,54377,26139,28238
2781,성북구 정릉1동,20222,54205,26023,28182
2782,성북구 정릉1동,20223,54040,25859,28181
2783,성북구 정릉1동,20224,53993,25813,28180
2784,성북구 정릉1동,20231,53803,25720,28083
2785,성북구 정릉1동,20232,53568,25646,27922
2786,성북구 정릉1동,20233,53542,25640,27902
2787,성북구 정릉1동,20234,53390,25550,27840
2788,성북구 정릉1동,20241,53266,25504,27762
2789,성북구 정릉1동,20242,53223,25495,27728
2790,성북구 정릉2동,20221,68917,33316,35601
2791,성북구 정릉2동,20222,68647,33218,35429
2792,성북구 정릉2동,20223,68397,33141,35256
2793,성북구 정릉2동,20224,68125,32957,35168
2794,성북구 정릉2동,20231,68025,32898,35127
2795,성북구 정릉2동,20232,67984,32832,35152
2796,성북구 정릉2동,20233,67905,32772,35133
2797,성북구 정릉2동,20234,67688,32613,35075
2798,성북구 정릉2동,20241,67499,32479,35020
2799,성북구 정릉2동,20242,67125,32272,34853
2800,성북구 정릉3동,20221,45477,22630,22847
2801,성북구 정릉3동,20222,45923,22917,23006
2802,성북구 정릉3동,20223,45865,22871,22994
2803,성북구 정릉3동,20224,45551,22682,22869
2804,성북구 정릉3동,20231,45373,22563,22810
2805,성북구 정릉3동,20232,45392,22621,22771
2806,성북구 정릉3동,20233,45180,22472,22708
2807,성북구 정릉3동,20234,44920,22356,22564
2808,성북구 정릉3동,20241,44929,22305,22624
2809,성북구 정릉3동,20242,45099,22373,22726
2810,성북구 정릉4동,20221,74386,35836,38550
2811,성북구 정릉4동,20222,74041,35620,38421
2812,성북구 정릉4동,20223,73693,35359,38334
2813,성북구 정릉4동,20224,73326,35183,38143
2814,성북구 정릉4동,20231,73242,35080,38162
2815,성북구 정릉4동,20232,72994,34939,38055
2816,성북구 정릉4동,20233,72598,34710,37888
2817,성북구 정릉4동,20234,72231,34486,37745
2818,성북구 정릉4동,20241,72057,34386,37671
2819,성북구 정릉4동,20242,72123,34469,37654
2820,성북구 종암동,20221,115928,57499,58429
2821,성북구 종암동,20222,115318,57089,58229
2822,성북구 종암동,20223,115207,56999,58208
2823,성북구 종암동,20224,114631,56679,57952
2824,성북구 종암동,20231,114327,56557,57770
2825,성북구 종암동,20232,114075,56368,57707
2826,성북구 종암동,20233,113792,56221,57571
2827,성북구 종암동,20234,113234,55959,57275
2828,성북구 종암동,20241,112564,55531,57033
2829,성북구 종암동,20242,112070,55218,56852
2830,송파구 가락1동,20221,82076,39760,42316
2831,송파구 가락1동,20222,82217,39829,42388
2832,송파구 가락1동,20223,82180,39836,42344
2833,송파구 가락1동,20224,82140,39829,42311
2834,송파구 가락1동,20231,82385,39924,42461
2835,송파구 가락1동,20232,82608,40073,42535
2836,송파구 가락1동,20233,82522,39969,42553
2837,송파구 가락1동,20234,82468,39880,42588
2838,송파구 가락1동,20241,82242,39786,42456
2839,송파구 가락1동,20242,82137,39710,42427
2840,송파구 가락2동,20221,95752,46940,48812
2841,송파구 가락2동,20222,95020,46513,48507
2842,송파구 가락2동,20223,94748,46350,48398
2843,송파구 가락2동,20224,94569,46192,48377
2844,송파구 가락2동,20231,94463,46155,48308
2845,송파구 가락2동,20232,94121,45930,48191
2846,송파구 가락2동,20233,93844,45799,48045
2847,송파구 가락2동,20234,93723,45695,48028
2848,송파구 가락2동,20241,93543,45504,48039
2849,송파구 가락2동,20242,93231,45327,47904
2850,송파구 가락본동,20221,78360,38861,39499
2851,송파구 가락본동,20222,77979,38689,39290
2852,송파구 가락본동,20223,77557,38466,39091
2853,송파구 가락본동,20224,77051,38225,38826
2854,송파구 가락본동,20231,76695,38023,38672
2855,송파구 가락본동,20232,76299,37746,38553
2856,송파구 가락본동,20233,76066,37653,38413
2857,송파구 가락본동,20234,75684,37490,38194
2858,송파구 가락본동,20241,75394,37287,38107
2859,송파구 가락본동,20242,75166,37081,38085
2860,송파구 거여1동,20221,37336,18837,18499
2861,송파구 거여1동,20222,37034,18625,18409
2862,송파구 거여1동,20223,36878,18525,18353
2863,송파구 거여1동,20224,36588,18413,18175
2864,송파구 거여1동,20231,36563,18398,18165
2865,송파구 거여1동,20232,36364,18249,18115
2866,송파구 거여1동,20233,36175,18115,18060
2867,송파구 거여1동,20234,36124,18075,18049
2868,송파구 거여1동,20241,35848,17898,17950
2869,송파구 거여1동,20242,35652,17745,17907
2870,송파구 거여2동,20221,63810,31361,32449
2871,송파구 거여2동,20222,69805,34252,35553
2872,송파구 거여2동,20223,70735,34650,36085
2873,송파구 거여2동,20224,70931,34644,36287
2874,송파구 거여2동,20231,70978,34636,36342
2875,송파구 거여2동,20232,71085,34622,36463
2876,송파구 거여2동,20233,70975,34629,36346
2877,송파구 거여2동,20234,70803,34531,36272
2878,송파구 거여2동,20241,70509,34397,36112
2879,송파구 거여2동,20242,70397,34300,36097
2880,송파구 마천1동,20221,56481,28892,27589
2881,송파구 마천1동,20222,56252,28712,27540
2882,송파구 마천1동,20223,56111,28723,27388
2883,송파구 마천1동,20224,55549,28488,27061
2884,송파구 마천1동,20231,55278,28353,26925
2885,송파구 마천1동,20232,55036,28220,26816
2886,송파구 마천1동,20233,54630,28011,26619
2887,송파구 마천1동,20234,54166,27749,26417
2888,송파구 마천1동,20241,53748,27488,26260
2889,송파구 마천1동,20242,53389,27292,26097
2890,송파구 마천2동,20221,55688,28403,27285
2891,송파구 마천2동,20222,55123,28143,26980
2892,송파구 마천2동,20223,54602,27884,26718
2893,송파구 마천2동,20224,54075,27666,26409
2894,송파구 마천2동,20231,53841,27579,26262
2895,송파구 마천2동,20232,53456,27332,26124
2896,송파구 마천2동,20233,53290,27239,26051
2897,송파구 마천2동,20234,52858,27029,25829
2898,송파구 마천2동,20241,52478,26786,25692
2899,송파구 마천2동,20242,51991,26506,25485
2900,송파구 문정1동,20221,59910,29697,30213
2901,송파구 문정1동,20222,59666,29529,30137
2902,송파구 문정1동,20223,59618,29418,30200
2903,송파구 문정1동,20224,59286,29230,30056
2904,송파구 문정1동,20231,59069,29125,29944
2905,송파구 문정1동,20232,58862,29009,29853
2906,송파구 문정1동,20233,58781,28989,29792
2907,송파구 문정1동,20234,58608,28981,29627
2908,송파구 문정1동,20241,58710,28964,29746
2909,송파구 문정1동,20242,59628,29243,30385
2910,송파구 문정2동,20221,86616,39720,46896
2911,송파구 문정2동,20222,86206,39456,46750
2912,송파구 문정2동,20223,86337,39540,46797
2913,송파구 문정2동,20224,86093,39440,46653
2914,송파구 문정2동,20231,86114,39394,46720
2915,송파구 문정2동,20232,86177,39469,46708
2916,송파구 문정2동,20233,86315,39554,46761
2917,송파구 문정2동,20234,86346,39553,46793
2918,송파구 문정2동,20241,86498,39693,46805
2919,송파구 문정2동,20242,86379,39640,46739
2920,송파구 방이1동,20221,46889,22640,24249
2921,송파구 방이1동,20222,46583,22480,24103
2922,송파구 방이1동,20223,46457,22446,24011
2923,송파구 방이1동,20224,46173,22291,23882
2924,송파구 방이1동,20231,45888,22175,23713
2925,송파구 방이1동,20232,45760,22115,23645
2926,송파구 방이1동,20233,45629,22014,23615
2927,송파구 방이1동,20234,45431,21898,23533
2928,송파구 방이1동,20241,45416,21825,23591
2929,송파구 방이1동,20242,45355,21741,23614
2930,송파구 방이2동,20221,79345,36780,42565
2931,송파구 방이2동,20222,78954,36509,42445
2932,송파구 방이2동,20223,78465,36069,42396
2933,송파구 방이2동,20224,77592,35611,41981
2934,송파구 방이2동,20231,77705,35597,42108
2935,송파구 방이2동,20232,77823,35583,42240
2936,송파구 방이2동,20233,78352,35756,42596
2937,송파구 방이2동,20234,78606,35851,42755
2938,송파구 방이2동,20241,79110,36042,43068
2939,송파구 방이2동,20242,79136,36090,43046
2940,송파구 삼전동,20221,90529,42441,48088
2941,송파구 삼전동,20222,89874,42086,47788
2942,송파구 삼전동,20223,89429,41906,47523
2943,송파구 삼전동,20224,88698,41484,47214
2944,송파구 삼전동,20231,88251,41109,47142
2945,송파구 삼전동,20232,87812,40806,47006
2946,송파구 삼전동,20233,87615,40737,46878
2947,송파구 삼전동,20234,87286,40642,46644
2948,송파구 삼전동,20241,87201,40646,46555
2949,송파구 삼전동,20242,86781,40442,46339
2950,송파구 석촌동,20221,94543,45071,49472
2951,송파구 석촌동,20222,94162,44785,49377
2952,송파구 석촌동,20223,93930,44691,49239
2953,송파구 석촌동,20224,93210,44246,48964
2954,송파구 석촌동,20231,93213,44259,48954
2955,송파구 석촌동,20232,92854,44012,48842
2956,송파구 석촌동,20233,92825,43990,48835
2957,송파구 석촌동,20234,92517,43845,48672
2958,송파구 석촌동,20241,92233,43595,48638
2959,송파구 석촌동,20242,92075,43552,48523
2960,송파구 송파1동,20221,71417,33360,38057
2961,송파구 송파1동,20222,71335,33412,37923
2962,송파구 송파1동,20223,71328,33382,37946
2963,송파구 송파1동,20224,71195,33290,37905
2964,송파구 송파1동,20231,70849,33084,37765
2965,송파구 송파1동,20232,70647,32961,37686
2966,송파구 송파1동,20233,70547,32839,37708
2967,송파구 송파1동,20234,70234,32555,37679
2968,송파구 송파1동,20241,70053,32424,37629
2969,송파구 송파1동,20242,70015,32314,37701
2970,송파구 송파2동,20221,57450,27676,29774
2971,송파구 송파2동,20222,57268,27553,29715
2972,송파구 송파2동,20223,56917,27370,29547
2973,송파구 송파2동,20224,56551,27209,29342
2974,송파구 송파2동,20231,56409,27127,29282
2975,송파구 송파2동,20232,56130,27031,29099
2976,송파구 송파2동,20233,55883,26957,28926
2977,송파구 송파2동,20234,55617,26822,28795
2978,송파구 송파2동,20241,55983,26942,29041
2979,송파구 송파2동,20242,55992,26970,29022
2980,송파구 오금동,20221,114759,55633,59126
2981,송파구 오금동,20222,114412,55525,58887
2982,송파구 오금동,20223,114127,55427,58700
2983,송파구 오금동,20224,113536,55145,58391
2984,송파구 오금동,20231,113237,54953,58284
2985,송파구 오금동,20232,112907,54765,58142
2986,송파구 오금동,20233,112621,54551,58070
2987,송파구 오금동,20234,112448,54358,58090
2988,송파구 오금동,20241,112893,54547,58346
2989,송파구 오금동,20242,113830,55025,58805
2990,송파구 오륜동,20221,53929,26324,27605
2991,송파구 오륜동,20222,53686,26200,27486
2992,송파구 오륜동,20223,53560,26135,27425
2993,송파구 오륜동,20224,53367,26033,27334
2994,송파구 오륜동,20231,53281,26018,27263
2995,송파구 오륜동,20232,53303,26047,27256
2996,송파구 오륜동,20233,53517,26181,27336
2997,송파구 오륜동,20234,53450,26193,27257
2998,송파구 오륜동,20241,53149,26023,27126
2999,송파구 오륜동,20242,53009,25970,27039
3000,송파구 위례동,20221,122966,59966,63000
3001,송파구 위례동,20222,130864,63847,67017
3002,송파구 위례동,20223,132405,64609,67796
3003,송파구 위례동,20224,133171,64994,68177
3004,송파구 위례동,20231,133614,65122,68492
3005,송파구 위례동,20232,133990,65287,68703
3006,송파구 위례동,20233,134118,65380,68738
3007,송파구 위례동,20234,134637,65630,69007
3008,송파구 위례동,20241,134796,65652,69144
3009,송파구 위례동,20242,134924,65663,69261
3010,송파구 잠실2동,20221,104831,50075,54756
3011,송파구 잠실2동,20222,104629,49936,54693
3012,송파구 잠실2동,20223,104376,49796,54580
3013,송파구 잠실2동,20224,104242,49718,54524
3014,송파구 잠실2동,20231,104519,49919,54600
3015,송파구 잠실2동,20232,104857,50091,54766
3016,송파구 잠실2동,20233,104772,50114,54658
3017,송파구 잠실2동,20234,104733,50103,54630
3018,송파구 잠실2동,20241,104599,50068,54531
3019,송파구 잠실2동,20242,104597,50025,54572
3020,송파구 잠실3동,20221,102854,48990,53864
3021,송파구 잠실3동,20222,102467,48767,53700
3022,송파구 잠실3동,20223,102158,48544,53614
3023,송파구 잠실3동,20224,102006,48462,53544
3024,송파구 잠실3동,20231,102059,48425,53634
3025,송파구 잠실3동,20232,101959,48310,53649
3026,송파구 잠실3동,20233,101746,48074,53672
3027,송파구 잠실3동,20234,101579,47940,53639
3028,송파구 잠실3동,20241,101523,47906,53617
3029,송파구 잠실3동,20242,101515,47911,53604
3030,송파구 잠실4동,20221,63923,30705,33218
3031,송파구 잠실4동,20222,63789,30634,33155
3032,송파구 잠실4동,20223,63582,30543,33039
3033,송파구 잠실4동,20224,63473,30545,32928
3034,송파구 잠실4동,20231,63521,30591,32930
3035,송파구 잠실4동,20232,63649,30665,32984
3036,송파구 잠실4동,20233,63582,30659,32923
3037,송파구 잠실4동,20234,63683,30694,32989
3038,송파구 잠실4동,20241,63577,30665,32912
3039,송파구 잠실4동,20242,63315,30529,32786
3040,송파구 잠실6동,20221,50291,23835,26456
3041,송파구 잠실6동,20222,50012,23701,26311
3042,송파구 잠실6동,20223,49908,23642,26266
3043,송파구 잠실6동,20224,49681,23536,26145
3044,송파구 잠실6동,20231,49602,23509,26093
3045,송파구 잠실6동,20232,49546,23485,26061
3046,송파구 잠실6동,20233,49450,23408,26042
3047,송파구 잠실6동,20234,49431,23410,26021
3048,송파구 잠실6동,20241,49495,23418,26077
3049,송파구 잠실6동,20242,49318,23320,25998
3050,송파구 잠실7동,20221,28631,13333,15298
3051,송파구 잠실7동,20222,28477,13256,15221
3052,송파구 잠실7동,20223,28420,13242,15178
3053,송파구 잠실7동,20224,28239,13158,15081
3054,송파구 잠실7동,20231,28276,13142,15134
3055,송파구 잠실7동,20232,28235,13144,15091
3056,송파구 잠실7동,20233,28274,13138,15136
3057,송파구 잠실7동,20234,28291,13150,15141
3058,송파구 잠실7동,20241,28278,13141,15137
3059,송파구 잠실7동,20242,28190,13094,15096
3060,송파구 잠실본동,20221,83759,39860,43899
3061,송파구 잠실본동,20222,83639,39954,43685
3062,송파구 잠실본동,20223,83765,40020,43745
3063,송파구 잠실본동,20224,83592,39876,43716
3064,송파구 잠실본동,20231,83566,39822,43744
3065,송파구 잠실본동,20232,83485,39823,43662
3066,송파구 잠실본동,20233,83276,39760,43516
3067,송파구 잠실본동,20234,83275,39676,43599
3068,송파구 잠실본동,20241,83415,39719,43696
3069,송파구 잠실본동,20242,83175,39573,43602
3070,송파구 장지동,20221,88227,42624,45603
3071,송파구 장지동,20222,87644,42341,45303
3072,송파구 장지동,20223,87343,42134,45209
3073,송파구 장지동,20224,86878,41880,44998
3074,송파구 장지동,20231,86732,41805,44927
3075,송파구 장지동,20232,86484,41651,44833
3076,송파구 장지동,20233,86008,41409,44599
3077,송파구 장지동,20234,85582,41236,44346
3078,송파구 장지동,20241,85102,41021,44081
3079,송파구 장지동,20242,84899,40850,44049
3080,송파구 풍납1동,20221,38356,18806,19550
3081,송파구 풍납1동,20222,38012,18693,19319
3082,송파구 풍납1동,20223,37697,18499,19198
3083,송파구 풍납1동,20224,37292,18274,19018
3084,송파구 풍납1동,20231,36891,18082,18809
3085,송파구 풍납1동,20232,36413,17892,18521
3086,송파구 풍납1동,20233,35917,17618,18299
3087,송파구 풍납1동,20234,35464,17408,18056
3088,송파구 풍납1동,20241,35275,17296,17979
3089,송파구 풍납1동,20242,34998,17187,17811
3090,송파구 풍납2동,20221,74190,35224,38966
3091,송파구 풍납2동,20222,73775,34966,38809
3092,송파구 풍납2동,20223,73247,34712,38535
3093,송파구 풍납2동,20224,72792,34508,38284
3094,송파구 풍납2동,20231,72479,34325,38154
3095,송파구 풍납2동,20232,72164,34130,38034
3096,송파구 풍납2동,20233,71793,33883,37910
3097,송파구 풍납2동,20234,71267,33603,37664
3098,송파구 풍납2동,20241,70579,33386,37193
3099,송파구 풍납2동,20242,70233,33248,36985
3100,양천구 목1동,20221,91922,44235,47687
3101,양천구 목1동,20222,91536,44060,47476
3102,양천구 목1동,20223,91482,44026,47456
3103,양천구 목1동,20224,91297,43907,47390
3104,양천구 목1동,20231,91000,43766,47234
3105,양천구 목1동,20232,90723,43571,47152
3106,양천구 목1동,20233,90688,43560,47128
3107,양천구 목1동,20234,90808,43634,47174
3108,양천구 목1동,20241,90708,43597,47111
3109,양천구 목1동,20242,90489,43417,47072
3110,양천구 목2동,20221,89599,43664,45935
3111,양천구 목2동,20222,89129,43350,45779
3112,양천구 목2동,20223,88905,43133,45772
3113,양천구 목2동,20224,88416,42843,45573
3114,양천구 목2동,20231,87876,42574,45302
3115,양천구 목2동,20232,87249,42167,45082
3116,양천구 목2동,20233,87011,42050,44961
3117,양천구 목2동,20234,86774,41951,44823
3118,양천구 목2동,20241,86391,41779,44612
3119,양천구 목2동,20242,86045,41568,44477
3120,양천구 목3동,20221,65524,31226,34298
3121,양천구 목3동,20222,65567,31243,34324
3122,양천구 목3동,20223,65407,31217,34190
3123,양천구 목3동,20224,64871,30915,33956
3124,양천구 목3동,20231,64543,30758,33785
3125,양천구 목3동,20232,64219,30598,33621
3126,양천구 목3동,20233,64012,30457,33555
3127,양천구 목3동,20234,63772,30260,33512
3128,양천구 목3동,20241,63589,30143,33446
3129,양천구 목3동,20242,63455,30054,33401
3130,양천구 목4동,20221,75983,37118,38865
3131,양천구 목4동,20222,75672,37011,38661
3132,양천구 목4동,20223,75236,36832,38404
3133,양천구 목4동,20224,74674,36554,38120
3134,양천구 목4동,20231,74270,36363,37907
3135,양천구 목4동,20232,73937,36162,37775
3136,양천구 목4동,20233,73724,35986,37738
3137,양천구 목4동,20234,73438,35797,37641
3138,양천구 목4동,20241,73198,35659,37539
3139,양천구 목4동,20242,72823,35446,37377
3140,양천구 목5동,20221,123238,61116,62122
3141,양천구 목5동,20222,122574,60724,61850
3142,양천구 목5동,20223,122243,60551,61692
3143,양천구 목5동,20224,122014,60475,61539
3144,양천구 목5동,20231,121803,60339,61464
3145,양천구 목5동,20232,121447,60093,61354
3146,양천구 목5동,20233,121624,60200,61424
3147,양천구 목5동,20234,122093,60484,61609
3148,양천구 목5동,20241,121992,60356,61636
3149,양천구 목5동,20242,121681,60170,61511
3150,양천구 신월1동,20221,61216,31409,29807
3151,양천구 신월1동,20222,61130,31359,29771
3152,양천구 신월1동,20223,60888,31193,29695
3153,양천구 신월1동,20224,60404,30966,29438
3154,양천구 신월1동,20231,60008,30735,29273
3155,양천구 신월1동,20232,59512,30465,29047
3156,양천구 신월1동,20233,58985,30238,28747
3157,양천구 신월1동,20234,58485,30025,28460
3158,양천구 신월1동,20241,58089,29825,28264
3159,양천구 신월1동,20242,57796,29709,28087
3160,양천구 신월2동,20221,61788,30145,31643
3161,양천구 신월2동,20222,61588,30006,31582
3162,양천구 신월2동,20223,61467,29992,31475
3163,양천구 신월2동,20224,61185,29931,31254
3164,양천구 신월2동,20231,61116,29894,31222
3165,양천구 신월2동,20232,62011,30250,31761
3166,양천구 신월2동,20233,62666,30551,32115
3167,양천구 신월2동,20234,62421,30438,31983
3168,양천구 신월2동,20241,62291,30406,31885
3169,양천구 신월2동,20242,62079,30300,31779
3170,양천구 신월3동,20221,45317,23930,21387
3171,양천구 신월3동,20222,45030,23780,21250
3172,양천구 신월3동,20223,44682,23525,21157
3173,양천구 신월3동,20224,44336,23347,20989
3174,양천구 신월3동,20231,44055,23173,20882
3175,양천구 신월3동,20232,43781,22999,20782
3176,양천구 신월3동,20233,43419,22860,20559
3177,양천구 신월3동,20234,42985,22613,20372
3178,양천구 신월3동,20241,42587,22380,20207
3179,양천구 신월3동,20242,42398,22260,20138
3180,양천구 신월4동,20221,53507,26141,27366
3181,양천구 신월4동,20222,53283,26012,27271
3182,양천구 신월4동,20223,53162,25904,27258
3183,양천구 신월4동,20224,52915,25768,27147
3184,양천구 신월4동,20231,52770,25682,27088
3185,양천구 신월4동,20232,52618,25585,27033
3186,양천구 신월4동,20233,52459,25520,26939
3187,양천구 신월4동,20234,52340,25453,26887
3188,양천구 신월4동,20241,52315,25417,26898
3189,양천구 신월4동,20242,52023,25239,26784
3190,양천구 신월5동,20221,43813,21788,22025
3191,양천구 신월5동,20222,43596,21688,21908
3192,양천구 신월5동,20223,43351,21581,21770
3193,양천구 신월5동,20224,43106,21407,21699
3194,양천구 신월5동,20231,42889,21276,21613
3195,양천구 신월5동,20232,42553,21122,21431
3196,양천구 신월5동,20233,42363,20993,21370
3197,양천구 신월5동,20234,42051,20807,21244
3198,양천구 신월5동,20241,41837,20694,21143
3199,양천구 신월5동,20242,41763,20603,21160
3200,양천구 신월6동,20221,41550,20304,21246
3201,양천구 신월6동,20222,41140,20093,21047
3202,양천구 신월6동,20223,41170,20089,21081
3203,양천구 신월6동,20224,41285,20148,21137
3204,양천구 신월6동,20231,41564,20292,21272
3205,양천구 신월6동,20232,41673,20351,21322
3206,양천구 신월6동,20233,41704,20357,21347
3207,양천구 신월6동,20234,41655,20336,21319
3208,양천구 신월6동,20241,41582,20325,21257
3209,양천구 신월6동,20242,41418,20231,21187
3210,양천구 신월7동,20221,58910,28807,30103
3211,양천구 신월7동,20222,58315,28543,29772
3212,양천구 신월7동,20223,57748,28201,29547
3213,양천구 신월7동,20224,57295,27955,29340
3214,양천구 신월7동,20231,56861,27745,29116
3215,양천구 신월7동,20232,56402,27518,28884
3216,양천구 신월7동,20233,56098,27335,28763
3217,양천구 신월7동,20234,55985,27247,28738
3218,양천구 신월7동,20241,55764,27113,28651
3219,양천구 신월7동,20242,55458,26958,28500
3220,양천구 신정1동,20221,60913,29693,31220
3221,양천구 신정1동,20222,60190,29366,30824
3222,양천구 신정1동,20223,59816,29121,30695
3223,양천구 신정1동,20224,59548,28966,30582
3224,양천구 신정1동,20231,59486,28878,30608
3225,양천구 신정1동,20232,59418,28854,30564
3226,양천구 신정1동,20233,59186,28736,30450
3227,양천구 신정1동,20234,59143,28731,30412
3228,양천구 신정1동,20241,59079,28712,30367
3229,양천구 신정1동,20242,58844,28575,30269
3230,양천구 신정2동,20221,58345,28659,29686
3231,양천구 신정2동,20222,57783,28347,29436
3232,양천구 신정2동,20223,57190,28028,29162
3233,양천구 신정2동,20224,56841,27866,28975
3234,양천구 신정2동,20231,56630,27813,28817
3235,양천구 신정2동,20232,56479,27766,28713
3236,양천구 신정2동,20233,56602,27825,28777
3237,양천구 신정2동,20234,56452,27684,28768
3238,양천구 신정2동,20241,56190,27528,28662
3239,양천구 신정2동,20242,55915,27390,28525
3240,양천구 신정3동,20221,149179,72491,76688
3241,양천구 신정3동,20222,150985,73294,77691
3242,양천구 신정3동,20223,150940,73224,77716
3243,양천구 신정3동,20224,150713,73057,77656
3244,양천구 신정3동,20231,150715,73003,77712
3245,양천구 신정3동,20232,150269,72701,77568
3246,양천구 신정3동,20233,149717,72393,77324
3247,양천구 신정3동,20234,149001,72058,76943
3248,양천구 신정3동,20241,147948,71447,76501
3249,양천구 신정3동,20242,147378,71064,76314
3250,양천구 신정4동,20221,98441,47939,50502
3251,양천구 신정4동,20222,98317,47864,50453
3252,양천구 신정4동,20223,97986,47716,50270
3253,양천구 신정4동,20224,97471,47469,50002
3254,양천구 신정4동,20231,97029,47193,49836
3255,양천구 신정4동,20232,96673,47031,49642
3256,양천구 신정4동,20233,96183,46819,49364
3257,양천구 신정4동,20234,95505,46392,49113
3258,양천구 신정4동,20241,95249,46250,48999
3259,양천구 신정4동,20242,94986,46053,48933
3260,양천구 신정6동,20221,73594,35802,37792
3261,양천구 신정6동,20222,73197,35633,37564
3262,양천구 신정6동,20223,72760,35413,37347
3263,양천구 신정6동,20224,72459,35237,37222
3264,양천구 신정6동,20231,72165,35053,37112
3265,양천구 신정6동,20232,71868,34887,36981
3266,양천구 신정6동,20233,71765,34815,36950
3267,양천구 신정6동,20234,71861,34795,37066
3268,양천구 신정6동,20241,71768,34731,37037
3269,양천구 신정6동,20242,71757,34766,36991
3270,양천구 신정7동,20221,86716,41896,44820
3271,양천구 신정7동,20222,86103,41549,44554
3272,양천구 신정7동,20223,85772,41356,44416
3273,양천구 신정7동,20224,85350,41074,44276
3274,양천구 신정7동,20231,85112,40918,44194
3275,양천구 신정7동,20232,85010,40839,44171
3276,양천구 신정7동,20233,84985,40747,44238
3277,양천구 신정7동,20234,84933,40704,44229
3278,양천구 신정7동,20241,84777,40592,44185
3279,양천구 신정7동,20242,84568,40484,44084
3280,영등포구 당산1동,20221,61086,29918,31168
3281,영등포구 당산1동,20222,61111,29879,31232
3282,영등포구 당산1동,20223,61270,29875,31395
3283,영등포구 당산1동,20224,61070,29755,31315
3284,영등포구 당산1동,20231,62299,30273,32026
3285,영등포구 당산1동,20232,62582,30339,32243
3286,영등포구 당산1동,20233,62874,30402,32472
3287,영등포구 당산1동,20234,63007,30380,32627
3288,영등포구 당산1동,20241,63304,30543,32761
3289,영등포구 당산1동,20242,63491,30555,32936
3290,영등포구 당산2동,20221,112708,52847,59861
3291,영등포구 당산2동,20222,112697,52852,59845
3292,영등포구 당산2동,20223,112457,52623,59834
3293,영등포구 당산2동,20224,110812,51732,59080
3294,영등포구 당산2동,20231,110223,51520,58703
3295,영등포구 당산2동,20232,110281,51480,58801
3296,영등포구 당산2동,20233,110314,51397,58917
3297,영등포구 당산2동,20234,110151,51370,58781
3298,영등포구 당산2동,20241,110081,51295,58786
3299,영등포구 당산2동,20242,109880,51243,58637
3300,영등포구 대림1동,20221,43431,21643,21788
3301,영등포구 대림1동,20222,42984,21385,21599
3302,영등포구 대림1동,20223,42717,21228,21489
3303,영등포구 대림1동,20224,42476,21135,21341
3304,영등포구 대림1동,20231,42214,20989,21225
3305,영등포구 대림1동,20232,42027,20928,21099
3306,영등포구 대림1동,20233,41726,20782,20944
3307,영등포구 대림1동,20234,41307,20548,20759
3308,영등포구 대림1동,20241,41172,20412,20760
3309,영등포구 대림1동,20242,41049,20313,20736
3310,영등포구 대림2동,20221,35818,17667,18151
3311,영등포구 대림2동,20222,35726,17597,18129
3312,영등포구 대림2동,20223,35553,17516,18037
3313,영등포구 대림2동,20224,35431,17404,18027
3314,영등포구 대림2동,20231,35893,17647,18246
3315,영등포구 대림2동,20232,35824,17584,18240
3316,영등포구 대림2동,20233,35750,17548,18202
3317,영등포구 대림2동,20234,35393,17341,18052
3318,영등포구 대림2동,20241,35093,17144,17949
3319,영등포구 대림2동,20242,35071,17088,17983
3320,영등포구 대림3동,20221,66717,33390,33327
3321,영등포구 대림3동,20222,66541,33239,33302
3322,영등포구 대림3동,20223,66182,33003,33179
3323,영등포구 대림3동,20224,65658,32717,32941
3324,영등포구 대림3동,20231,65638,32754,32884
3325,영등포구 대림3동,20232,65452,32693,32759
3326,영등포구 대림3동,20233,65105,32510,32595
3327,영등포구 대림3동,20234,64784,32332,32452
3328,영등포구 대림3동,20241,64599,32192,32407
3329,영등포구 대림3동,20242,64402,32124,32278
3330,영등포구 도림동,20221,53286,26891,26395
3331,영등포구 도림동,20222,53491,26988,26503
3332,영등포구 도림동,20223,53340,26948,26392
3333,영등포구 도림동,20224,53093,26818,26275
3334,영등포구 도림동,20231,53127,26830,26297
3335,영등포구 도림동,20232,53145,26832,26313
3336,영등포구 도림동,20233,52968,26799,26169
3337,영등포구 도림동,20234,52718,26707,26011
3338,영등포구 도림동,20241,52731,26689,26042
3339,영등포구 도림동,20242,52906,26738,26168
3340,영등포구 문래동,20221,97782,47862,49920
3341,영등포구 문래동,20222,97508,47680,49828
3342,영등포구 문래동,20223,97267,47525,49742
3343,영등포구 문래동,20224,96997,47381,49616
3344,영등포구 문래동,20231,96825,47249,49576
3345,영등포구 문래동,20232,96554,47061,49493
3346,영등포구 문래동,20233,96575,47060,49515
3347,영등포구 문래동,20234,96371,46924,49447
3348,영등포구 문래동,20241,96335,46838,49497
3349,영등포구 문래동,20242,96174,46782,49392
3350,영등포구 신길1동,20221,52065,26542,25523
3351,영등포구 신길1동,20222,52048,26551,25497
3352,영등포구 신길1동,20223,54609,27707,26902
3353,영등포구 신길1동,20224,57254,29003,28251
3354,영등포구 신길1동,20231,57959,29317,28642
3355,영등포구 신길1동,20232,58238,29413,28825
3356,영등포구 신길1동,20233,58089,29348,28741
3357,영등포구 신길1동,20234,57968,29313,28655
3358,영등포구 신길1동,20241,57848,29222,28626
3359,영등포구 신길1동,20242,57774,29207,28567
3360,영등포구 신길3동,20221,49771,24601,25170
3361,영등포구 신길3동,20222,49497,24481,25016
3362,영등포구 신길3동,20223,49363,24365,24998
3363,영등포구 신길3동,20224,49074,24209,24865
3364,영등포구 신길3동,20231,48941,24132,24809
3365,영등포구 신길3동,20232,48789,24020,24769
3366,영등포구 신길3동,20233,48581,23928,24653
3367,영등포구 신길3동,20234,48088,23664,24424
3368,영등포구 신길3동,20241,47931,23640,24291
3369,영등포구 신길3동,20242,47824,23529,24295
3370,영등포구 신길4동,20221,37074,18475,18599
3371,영등포구 신길4동,20222,37070,18458,18612
3372,영등포구 신길4동,20223,37008,18367,18641
3373,영등포구 신길4동,20224,36952,18316,18636
3374,영등포구 신길4동,20231,36962,18316,18646
3375,영등포구 신길4동,20232,37021,18342,18679
3376,영등포구 신길4동,20233,36891,18276,18615
3377,영등포구 신길4동,20234,36661,18165,18496
3378,영등포구 신길4동,20241,36388,18007,18381
3379,영등포구 신길4동,20242,36271,17912,18359
3380,영등포구 신길5동,20221,31556,15384,16172
3381,영등포구 신길5동,20222,31261,15208,16053
3382,영등포구 신길5동,20223,30942,15075,15867
3383,영등포구 신길5동,20224,30694,14920,15774
3384,영등포구 신길5동,20231,30567,14796,15771
3385,영등포구 신길5동,20232,30435,14734,15701
3386,영등포구 신길5동,20233,30245,14635,15610
3387,영등포구 신길5동,20234,29915,14471,15444
3388,영등포구 신길5동,20241,29631,14343,15288
3389,영등포구 신길5동,20242,29402,14234,15168
3390,영등포구 신길6동,20221,57138,27940,29198
3391,영등포구 신길6동,20222,57201,27967,29234
3392,영등포구 신길6동,20223,57100,27967,29133
3393,영등포구 신길6동,20224,56693,27738,28955
3394,영등포구 신길6동,20231,56438,27586,28852
3395,영등포구 신길6동,20232,55316,26980,28336
3396,영등포구 신길6동,20233,53841,26187,27654
3397,영등포구 신길6동,20234,53311,25961,27350
3398,영등포구 신길6동,20241,52984,25844,27140
3399,영등포구 신길6동,20242,52767,25805,26962
3400,영등포구 신길7동,20221,59887,29868,30019
3401,영등포구 신길7동,20222,59804,29846,29958
3402,영등포구 신길7동,20223,59542,29710,29832
3403,영등포구 신길7동,20224,59051,29374,29677
3404,영등포구 신길7동,20231,59325,29551,29774
3405,영등포구 신길7동,20232,59448,29647,29801
3406,영등포구 신길7동,20233,59595,29670,29925
3407,영등포구 신길7동,20234,59496,29575,29921
3408,영등포구 신길7동,20241,59268,29463,29805
3409,영등포구 신길7동,20242,59144,29347,29797
3410,영등포구 양평1동,20221,54990,26802,28188
3411,영등포구 양평1동,20222,55082,26881,28201
3412,영등포구 양평1동,20223,55209,26938,28271
3413,영등포구 양평1동,20224,55113,26805,28308
3414,영등포구 양평1동,20231,55029,26645,28384
3415,영등포구 양평1동,20232,54822,26524,28298
3416,영등포구 양평1동,20233,54574,26293,28281
3417,영등포구 양평1동,20234,54499,26209,28290
3418,영등포구 양평1동,20241,54595,26182,28413
3419,영등포구 양평1동,20242,54602,26135,28467
3420,영등포구 양평2동,20221,66772,32742,34030
3421,영등포구 양평2동,20222,66843,32702,34141
3422,영등포구 양평2동,20223,67135,32847,34288
3423,영등포구 양평2동,20224,67142,32779,34363
3424,영등포구 양평2동,20231,67175,32729,34446
3425,영등포구 양평2동,20232,67446,32771,34675
3426,영등포구 양평2동,20233,67537,32818,34719
3427,영등포구 양평2동,20234,67542,32933,34609
3428,영등포구 양평2동,20241,68031,33115,34916
3429,영등포구 양평2동,20242,68351,33170,35181
3430,영등포구 여의동,20221,98803,46344,52459
3431,영등포구 여의동,20222,98354,46127,52227
3432,영등포구 여의동,20223,98137,46066,52071
3433,영등포구 여의동,20224,97758,45888,51870
3434,영등포구 여의동,20231,97480,45756,51724
3435,영등포구 여의동,20232,97687,45841,51846
3436,영등포구 여의동,20233,98299,46113,52186
3437,영등포구 여의동,20234,99589,46728,52861
3438,영등포구 여의동,20241,100547,47184,53363
3439,영등포구 여의동,20242,101002,47430,53572
3440,영등포구 영등포동,20221,87958,45920,42038
3441,영등포구 영등포동,20222,88317,45884,42433
3442,영등포구 영등포동,20223,88843,46061,42782
3443,영등포구 영등포동,20224,88990,45971,43019
3444,영등포구 영등포동,20231,90177,46412,43765
3445,영등포구 영등포동,20232,91041,46778,44263
3446,영등포구 영등포동,20233,91343,46928,44415
3447,영등포구 영등포동,20234,91678,46983,44695
3448,영등포구 영등포동,20241,92253,47113,45140
3449,영등포구 영등포동,20242,92973,47270,45703
3450,영등포구 영등포본동,20221,63731,32648,31083
3451,영등포구 영등포본동,20222,63657,32609,31048
3452,영등포구 영등포본동,20223,63498,32550,30948
3453,영등포구 영등포본동,20224,63051,32326,30725
3454,영등포구 영등포본동,20231,62893,32267,30626
3455,영등포구 영등포본동,20232,62801,32236,30565
3456,영등포구 영등포본동,20233,62802,32192,30610
3457,영등포구 영등포본동,20234,62512,31935,30577
3458,영등포구 영등포본동,20241,62310,31814,30496
3459,영등포구 영등포본동,20242,62156,31777,30379
3460,용산구 남영동,20221,22081,13420,8661
3461,용산구 남영동,20222,21916,13312,8604
3462,용산구 남영동,20223,21635,13149,8486
3463,용산구 남영동,20224,21324,12949,8375
3464,용산구 남영동,20231,21227,12883,8344
3465,용산구 남영동,20232,20975,12738,8237
3466,용산구 남영동,20233,20719,12595,8124
3467,용산구 남영동,20234,20514,12509,8005
3468,용산구 남영동,20241,20464,12513,7951
3469,용산구 남영동,20242,20455,12511,7944
3470,용산구 보광동,20221,40174,19960,20214
3471,용산구 보광동,20222,39737,19730,20007
3472,용산구 보광동,20223,39177,19499,19678
3473,용산구 보광동,20224,38336,19112,19224
3474,용산구 보광동,20231,38030,18988,19042
3475,용산구 보광동,20232,37594,18801,18793
3476,용산구 보광동,20233,37006,18479,18527
3477,용산구 보광동,20234,34867,17425,17442
3478,용산구 보광동,20241,30471,15225,15246
3479,용산구 보광동,20242,23902,11966,11936
3480,용산구 서빙고동,20221,39039,18656,20383
3481,용산구 서빙고동,20222,38941,18632,20309
3482,용산구 서빙고동,20223,38560,18504,20056
3483,용산구 서빙고동,20224,37932,18228,19704
3484,용산구 서빙고동,20231,37657,18124,19533
3485,용산구 서빙고동,20232,37607,18128,19479
3486,용산구 서빙고동,20233,37550,18084,19466
3487,용산구 서빙고동,20234,37352,17997,19355
3488,용산구 서빙고동,20241,37499,18033,19466
3489,용산구 서빙고동,20242,37691,18119,19572
3490,용산구 용문동,20221,35497,16974,18523
3491,용산구 용문동,20222,35268,16915,18353
3492,용산구 용문동,20223,34961,16788,18173
3493,용산구 용문동,20224,34673,16638,18035
3494,용산구 용문동,20231,34510,16555,17955
3495,용산구 용문동,20232,34406,16480,17926
3496,용산구 용문동,20233,34435,16486,17949
3497,용산구 용문동,20234,34276,16366,17910
3498,용산구 용문동,20241,34093,16239,17854
3499,용산구 용문동,20242,33912,16084,17828
3500,용산구 용산2가동,20221,28289,13676,14613
3501,용산구 용산2가동,20222,28071,13545,14526
3502,용산구 용산2가동,20223,27730,13367,14363
3503,용산구 용산2가동,20224,27208,13156,14052
3504,용산구 용산2가동,20231,27075,13070,14005
3505,용산구 용산2가동,20232,27009,13039,13970
3506,용산구 용산2가동,20233,26934,13062,13872
3507,용산구 용산2가동,20234,26760,13022,13738
3508,용산구 용산2가동,20241,26650,13004,13646
3509,용산구 용산2가동,20242,26538,13016,13522
3510,용산구 원효로1동,20221,47959,22735,25224
3511,용산구 원효로1동,20222,48661,22888,25773
3512,용산구 원효로1동,20223,50591,23619,26972
3513,용산구 원효로1동,20224,51330,23894,27436
3514,용산구 원효로1동,20231,51450,23921,27529
3515,용산구 원효로1동,20232,51486,23965,27521
3516,용산구 원효로1동,20233,51601,24001,27600
3517,용산구 원효로1동,20234,51161,23774,27387
3518,용산구 원효로1동,20241,51045,23688,27357
3519,용산구 원효로1동,20242,51041,23603,27438
3520,용산구 원효로2동,20221,41184,19408,21776
3521,용산구 원효로2동,20222,41150,19373,21777
3522,용산구 원효로2동,20223,41069,19318,21751
3523,용산구 원효로2동,20224,41074,19376,21698
3524,용산구 원효로2동,20231,41049,19336,21713
3525,용산구 원효로2동,20232,41109,19315,21794
3526,용산구 원효로2동,20233,41029,19267,21762
3527,용산구 원효로2동,20234,40901,19205,21696
3528,용산구 원효로2동,20241,40860,19191,21669
3529,용산구 원효로2동,20242,40750,19139,21611
3530,용산구 이촌1동,20221,77384,36231,41153
3531,용산구 이촌1동,20222,77101,36130,40971
3532,용산구 이촌1동,20223,76312,35832,40480
3533,용산구 이촌1동,20224,75222,35330,39892
3534,용산구 이촌1동,20231,75033,35224,39809
3535,용산구 이촌1동,20232,74972,35206,39766
3536,용산구 이촌1동,20233,74999,35227,39772
3537,용산구 이촌1동,20234,74885,35183,39702
3538,용산구 이촌1동,20241,74819,35144,39675
3539,용산구 이촌1동,20242,74828,35134,39694
3540,용산구 이촌2동,20221,24751,11580,13171
3541,용산구 이촌2동,20222,24571,11488,13083
3542,용산구 이촌2동,20223,24424,11410,13014
3543,용산구 이촌2동,20224,24120,11267,12853
3544,용산구 이촌2동,20231,24001,11217,12784
3545,용산구 이촌2동,20232,23917,11188,12729
3546,용산구 이촌2동,20233,23809,11162,12647
3547,용산구 이촌2동,20234,23668,11123,12545
3548,용산구 이촌2동,20241,23599,11059,12540
3549,용산구 이촌2동,20242,23460,10970,12490
3550,용산구 이태원1동,20221,19060,9291,9769
3551,용산구 이태원1동,20222,18887,9211,9676
3552,용산구 이태원1동,20223,18741,9225,9516
3553,용산구 이태원1동,20224,18359,9083,9276
3554,용산구 이태원1동,20231,18372,9076,9296
3555,용산구 이태원1동,20232,18317,9087,9230
3556,용산구 이태원1동,20233,18155,9083,9072
3557,용산구 이태원1동,20234,18077,9045,9032
3558,용산구 이태원1동,20241,18095,9046,9049
3559,용산구 이태원1동,20242,18372,9185,9187
3560,용산구 이태원2동,20221,26865,12315,14550
3561,용산구 이태원2동,20222,26690,12267,14423
3562,용산구 이태원2동,20223,26517,12218,14299
3563,용산구 이태원2동,20224,26249,12130,14119
3564,용산구 이태원2동,20231,26052,12102,13950
3565,용산구 이태원2동,20232,25990,12143,13847
3566,용산구 이태원2동,20233,25924,12128,13796
3567,용산구 이태원2동,20234,25926,12123,13803
3568,용산구 이태원2동,20241,26085,12258,13827
3569,용산구 이태원2동,20242,26160,12360,13800
3570,용산구 청파동,20221,58367,27262,31105
3571,용산구 청파동,20222,58016,26978,31038
3572,용산구 청파동,20223,57812,26935,30877
3573,용산구 청파동,20224,57290,26707,30583
3574,용산구 청파동,20231,57262,26689,30573
3575,용산구 청파동,20232,57167,26573,30594
3576,용산구 청파동,20233,57023,26426,30597
3577,용산구 청파동,20234,56783,26326,30457
3578,용산구 청파동,20241,56549,26203,30346
3579,용산구 청파동,20242,56375,26053,30322
3580,용산구 한강로동,20221,65069,30923,34146
3581,용산구 한강로동,20222,64753,30777,33976
3582,용산구 한강로동,20223,64566,30646,33920
3583,용산구 한강로동,20224,63792,30296,33496
3584,용산구 한강로동,20231,63437,30088,33349
3585,용산구 한강로동,20232,63459,30071,33388
3586,용산구 한강로동,20233,63362,29934,33428
3587,용산구 한강로동,20234,63222,29823,33399
3588,용산구 한강로동,20241,62837,29647,33190
3589,용산구 한강로동,20242,62720,29663,33057
3590,용산구 한남동,20221,60946,29354,31592
3591,용산구 한남동,20222,60848,29329,31519
3592,용산구 한남동,20223,60060,28921,31139
3593,용산구 한남동,20224,58566,28247,30319
3594,용산구 한남동,20231,58111,28077,30034
3595,용산구 한남동,20232,57528,27808,29720
3596,용산구 한남동,20233,56784,27481,29303
3597,용산구 한남동,20234,54405,26284,28121
3598,용산구 한남동,20241,50468,24194,26274
3599,용산구 한남동,20242,44679,21208,23471
3600,용산구 효창동,20221,30098,14281,15817
3601,용산구 효창동,20222,31742,15094,16648
3602,용산구 효창동,20223,32062,15237,16825
3603,용산구 효창동,20224,32183,15309,16874
3604,용산구 효창동,20231,32251,15337,16914
3605,용산구 효창동,20232,32280,15327,16953
3606,용산구 효창동,20233,32153,15246,16907
3607,용산구 효창동,20234,32102,15213,16889
3608,용산구 효창동,20241,31865,14995,16870
3609,용산구 효창동,20242,31849,14968,16881
3610,용산구 후암동,20221,50392,24600,25792
3611,용산구 후암동,20222,50003,24385,25618
3612,용산구 후암동,20223,49550,24146,25404
3613,용산구 후암동,20224,49039,23890,25149
3614,용산구 후암동,20231,48826,23787,25039
3615,용산구 후암동,20232,48521,23563,24958
3616,용산구 후암동,20233,48258,23357,24901
3617,용산구 후암동,20234,48030,23217,24813
3618,용산구 후암동,20241,47872,23104,24768
3619,용산구 후암동,20242,47773,22964,24809
3620,은평구 갈현1동,20221,64990,31750,33240
3621,은평구 갈현1동,20222,64105,31312,32793
3622,은평구 갈현1동,20223,61864,30248,31616
3623,은평구 갈현1동,20224,54022,26418,27604
3624,은평구 갈현1동,20231,47142,22925,24217
3625,은평구 갈현1동,20232,44857,21832,23025
3626,은평구 갈현1동,20233,44148,21436,22712
3627,은평구 갈현1동,20234,43648,21183,22465
3628,은평구 갈현1동,20241,43272,20943,22329
3629,은평구 갈현1동,20242,42960,20797,22163
3630,은평구 갈현2동,20221,84516,40057,44459
3631,은평구 갈현2동,20222,84190,39880,44310
3632,은평구 갈현2동,20223,84051,39849,44202
3633,은평구 갈현2동,20224,83732,39607,44125
3634,은평구 갈현2동,20231,83634,39510,44124
3635,은평구 갈현2동,20232,83187,39291,43896
3636,은평구 갈현2동,20233,82783,39054,43729
3637,은평구 갈현2동,20234,82488,38928,43560
3638,은평구 갈현2동,20241,82245,38851,43394
3639,은평구 갈현2동,20242,82106,38734,43372
3640,은평구 구산동,20221,96393,47207,49186
3641,은평구 구산동,20222,96331,47064,49267
3642,은평구 구산동,20223,96048,46919,49129
3643,은평구 구산동,20224,95566,46668,48898
3644,은평구 구산동,20231,95336,46531,48805
3645,은평구 구산동,20232,95061,46226,48835
3646,은평구 구산동,20233,94679,46017,48662
3647,은평구 구산동,20234,94461,45910,48551
3648,은평구 구산동,20241,94111,45615,48496
3649,은평구 구산동,20242,93784,45280,48504
3650,은평구 녹번동,20221,110301,52201,58100
3651,은평구 녹번동,20222,110144,52020,58124
3652,은평구 녹번동,20223,109925,51820,58105
3653,은평구 녹번동,20224,109577,51598,57979
3654,은평구 녹번동,20231,109279,51398,57881
3655,은평구 녹번동,20232,109043,51265,57778
3656,은평구 녹번동,20233,108698,51075,57623
3657,은평구 녹번동,20234,108355,50872,57483
3658,은평구 녹번동,20241,108065,50692,57373
3659,은평구 녹번동,20242,107759,50480,57279
3660,은평구 대조동,20221,80625,37426,43199
3661,은평구 대조동,20222,80454,37279,43175
3662,은평구 대조동,20223,80225,37255,42970
3663,은평구 대조동,20224,79501,36942,42559
3664,은평구 대조동,20231,81517,37751,43766
3665,은평구 대조동,20232,81812,37878,43934
3666,은평구 대조동,20233,81882,37837,44045
3667,은평구 대조동,20234,82064,37883,44181
3668,은평구 대조동,20241,82173,37900,44273
3669,은평구 대조동,20242,82471,38026,44445
3670,은평구 불광1동,20221,115335,54361,60974
3671,은평구 불광1동,20222,114974,54133,60841
3672,은평구 불광1동,20223,114496,53899,60597
3673,은평구 불광1동,20224,113987,53694,60293
3674,은평구 불광1동,20231,113627,53486,60141
3675,은평구 불광1동,20232,113280,53178,60102
3676,은평구 불광1동,20233,112920,52987,59933
3677,은평구 불광1동,20234,112465,52800,59665
3678,은평구 불광1동,20241,112482,52826,59656
3679,은평구 불광1동,20242,112617,52865,59752
3680,은평구 불광2동,20221,82398,39853,42545
3681,은평구 불광2동,20222,81946,39547,42399
3682,은평구 불광2동,20223,81417,39241,42176
3683,은평구 불광2동,20224,81043,39165,41878
3684,은평구 불광2동,20231,81290,39265,42025
3685,은평구 불광2동,20232,81123,39099,42024
3686,은평구 불광2동,20233,80689,38862,41827
3687,은평구 불광2동,20234,80238,38586,41652
3688,은평구 불광2동,20241,80195,38601,41594
3689,은평구 불광2동,20242,80030,38535,41495
3690,은평구 수색동,20221,39183,19263,19920
3691,은평구 수색동,20222,39568,19421,20147
3692,은평구 수색동,20223,39412,19342,20070
3693,은평구 수색동,20224,39378,19294,20084
3694,은평구 수색동,20231,39335,19165,20170
3695,은평구 수색동,20232,39549,19279,20270
3696,은평구 수색동,20233,50542,24591,25951
3697,은평구 수색동,20234,60621,29486,31135
3698,은평구 수색동,20241,62001,30095,31906
3699,은평구 수색동,20242,62591,30273,32318
3700,은평구 신사1동,20221,80923,38917,42006
3701,은평구 신사1동,20222,80574,38729,41845
3702,은평구 신사1동,20223,80547,38735,41812
3703,은평구 신사1동,20224,80353,38582,41771
3704,은평구 신사1동,20231,80243,38520,41723
3705,은평구 신사1동,20232,80066,38440,41626
3706,은평구 신사1동,20233,79765,38219,41546
3707,은평구 신사1동,20234,79497,38114,41383
3708,은평구 신사1동,20241,79226,37995,41231
3709,은평구 신사1동,20242,79053,37869,41184
3710,은평구 신사2동,20221,60199,30024,30175
3711,은평구 신사2동,20222,59207,29486,29721
3712,은평구 신사2동,20223,58689,29211,29478
3713,은평구 신사2동,20224,58248,28953,29295
3714,은평구 신사2동,20231,57885,28783,29102
3715,은평구 신사2동,20232,57580,28609,28971
3716,은평구 신사2동,20233,57240,28405,28835
3717,은평구 신사2동,20234,56863,28206,28657
3718,은평구 신사2동,20241,56629,27998,28631
3719,은평구 신사2동,20242,56639,27991,28648
3720,은평구 역촌동,20221,135907,63773,72134
3721,은평구 역촌동,20222,135222,63420,71802
3722,은평구 역촌동,20223,134459,63015,71444
3723,은평구 역촌동,20224,133803,62744,71059
3724,은평구 역촌동,20231,133594,62756,70838
3725,은평구 역촌동,20232,133082,62457,70625
3726,은평구 역촌동,20233,132335,62063,70272
3727,은평구 역촌동,20234,131640,61617,70023
3728,은평구 역촌동,20241,131098,61279,69819
3729,은평구 역촌동,20242,130746,61152,69594
3730,은평구 응암1동,20221,98940,46850,52090
3731,은평구 응암1동,20222,98875,46734,52141
3732,은평구 응암1동,20223,98655,46519,52136
3733,은평구 응암1동,20224,98797,46485,52312
3734,은평구 응암1동,20231,98935,46506,52429
3735,은평구 응암1동,20232,98766,46338,52428
3736,은평구 응암1동,20233,98434,46127,52307
3737,은평구 응암1동,20234,98012,45841,52171
3738,은평구 응암1동,20241,97999,45769,52230
3739,은평구 응암1동,20242,97593,45553,52040
3740,은평구 응암2동,20221,84077,40780,43297
3741,은평구 응암2동,20222,84108,40746,43362
3742,은평구 응암2동,20223,83899,40629,43270
3743,은평구 응암2동,20224,83561,40475,43086
3744,은평구 응암2동,20231,83243,40281,42962
3745,은평구 응암2동,20232,83048,40138,42910
3746,은평구 응암2동,20233,82951,40074,42877
3747,은평구 응암2동,20234,82063,39634,42429
3748,은평구 응암2동,20241,81880,39558,42322
3749,은평구 응암2동,20242,81905,39573,42332
3750,은평구 응암3동,20221,72898,35431,37467
3751,은평구 응암3동,20222,72679,35322,37357
3752,은평구 응암3동,20223,72449,35164,37285
3753,은평구 응암3동,20224,71969,34889,37080
3754,은평구 응암3동,20231,71625,34612,37013
3755,은평구 응암3동,20232,71024,34214,36810
3756,은평구 응암3동,20233,70743,34066,36677
3757,은평구 응암3동,20234,70414,33900,36514
3758,은평구 응암3동,20241,70212,33786,36426
3759,은평구 응암3동,20242,70110,33797,36313
3760,은평구 증산동,20221,44705,21789,22916
3761,은평구 증산동,20222,52041,25430,26611
3762,은평구 증산동,20223,54988,26853,28135
3763,은평구 증산동,20224,55368,27014,28354
3764,은평구 증산동,20231,55561,27082,28479
3765,은평구 증산동,20232,55446,26954,28492
3766,은평구 증산동,20233,55241,26781,28460
3767,은평구 증산동,20234,54882,26588,28294
3768,은평구 증산동,20241,54523,26426,28097
3769,은평구 증산동,20242,53612,26065,27547
3770,은평구 진관동,20221,166631,78168,88463
3771,은평구 진관동,20222,166056,77816,88240
3772,은평구 진관동,20223,165648,77522,88126
3773,은평구 진관동,20224,164680,77026,87654
3774,은평구 진관동,20231,164489,76832,87657
3775,은평구 진관동,20232,164203,76607,87596
3776,은평구 진관동,20233,163727,76294,87433
3777,은평구 진관동,20234,163151,75881,87270
3778,은평구 진관동,20241,162431,75468,86963
3779,은평구 진관동,20242,161729,74927,86802
3780,종로구 가회동,20221,12179,5617,6562
3781,종로구 가회동,20222,12091,5549,6542
3782,종로구 가회동,20223,11947,5507,6440
3783,종로구 가회동,20224,11850,5478,6372
3784,종로구 가회동,20231,11893,5519,6374
3785,종로구 가회동,20232,11775,5476,6299
3786,종로구 가회동,20233,11695,5419,6276
3787,종로구 가회동,20234,11594,5374,6220
3788,종로구 가회동,20241,11579,5397,6182
3789,종로구 가회동,20242,11457,5368,6089
3790,종로구 교남동,20221,30040,13806,16234
3791,종로구 교남동,20222,29883,13740,16143
3792,종로구 교남동,20223,29761,13707,16054
3793,종로구 교남동,20224,29521,13607,15914
3794,종로구 교남동,20231,29328,13493,15835
3795,종로구 교남동,20232,29272,13455,15817
3796,종로구 교남동,20233,29122,13382,15740
3797,종로구 교남동,20234,29100,13361,15739
3798,종로구 교남동,20241,29081,13345,15736
3799,종로구 교남동,20242,29069,13338,15731
3800,종로구 무악동,20221,24685,11458,13227
3801,종로구 무악동,20222,24479,11359,13120
3802,종로구 무악동,20223,24292,11261,13031
3803,종로구 무악동,20224,24096,11143,12953
3804,종로구 무악동,20231,24045,11094,12951
3805,종로구 무악동,20232,23992,11037,12955
3806,종로구 무악동,20233,24003,10998,13005
3807,종로구 무악동,20234,23931,10969,12962
3808,종로구 무악동,20241,23944,10977,12967
3809,종로구 무악동,20242,23858,10948,12910
3810,종로구 부암동,20221,28616,13651,14965
3811,종로구 부암동,20222,28363,13506,14857
3812,종로구 부암동,20223,28148,13397,14751
3813,종로구 부암동,20224,27802,13196,14606
3814,종로구 부암동,20231,27524,13020,14504
3815,종로구 부암동,20232,27413,12968,14445
3816,종로구 부암동,20233,27342,12946,14396
3817,종로구 부암동,20234,27316,12933,14383
3818,종로구 부암동,20241,27180,12861,14319
3819,종로구 부암동,20242,27161,12780,14381
3820,종로구 사직동,20221,28081,12567,15514
3821,종로구 사직동,20222,27965,12473,15492
3822,종로구 사직동,20223,27696,12291,15405
3823,종로구 사직동,20224,27321,12124,15197
3824,종로구 사직동,20231,27357,12174,15183
3825,종로구 사직동,20232,27297,12113,15184
3826,종로구 사직동,20233,27202,12084,15118
3827,종로구 사직동,20234,27019,11993,15026
3828,종로구 사직동,20241,26983,11909,15074
3829,종로구 사직동,20242,26950,11832,15118
3830,종로구 삼청동,20221,7339,3509,3830
3831,종로구 삼청동,20222,7188,3415,3773
3832,종로구 삼청동,20223,7113,3379,3734
3833,종로구 삼청동,20224,7012,3339,3673
3834,종로구 삼청동,20231,6960,3315,3645
3835,종로구 삼청동,20232,6869,3279,3590
3836,종로구 삼청동,20233,6762,3235,3527
3837,종로구 삼청동,20234,6736,3222,3514
3838,종로구 삼청동,20241,6726,3209,3517
3839,종로구 삼청동,20242,6679,3177,3502
3840,종로구 숭인1동,20221,17539,8430,9109
3841,종로구 숭인1동,20222,17550,8464,9086
3842,종로구 숭인1동,20223,17453,8400,9053
3843,종로구 숭인1동,20224,17336,8347,8989
3844,종로구 숭인1동,20231,17330,8351,8979
3845,종로구 숭인1동,20232,17296,8342,8954
3846,종로구 숭인1동,20233,17304,8357,8947
3847,종로구 숭인1동,20234,17335,8409,8926
3848,종로구 숭인1동,20241,17429,8432,8997
3849,종로구 숭인1동,20242,17349,8384,8965
3850,종로구 숭인2동,20221,29058,14578,14480
3851,종로구 숭인2동,20222,29139,14532,14607
3852,종로구 숭인2동,20223,29503,14645,14858
3853,종로구 숭인2동,20224,29485,14531,14954
3854,종로구 숭인2동,20231,29465,14506,14959
3855,종로구 숭인2동,20232,29309,14367,14942
3856,종로구 숭인2동,20233,29183,14338,14845
3857,종로구 숭인2동,20234,29353,14337,15016
3858,종로구 숭인2동,20241,29861,14521,15340
3859,종로구 숭인2동,20242,30245,14681,15564
3860,종로구 이화동,20221,21695,10302,11393
3861,종로구 이화동,20222,21671,10303,11368
3862,종로구 이화동,20223,21527,10201,11326
3863,종로구 이화동,20224,21318,10077,11241
3864,종로구 이화동,20231,21248,10068,11180
3865,종로구 이화동,20232,21083,10011,11072
3866,종로구 이화동,20233,20978,9949,11029
3867,종로구 이화동,20234,20733,9859,10874
3868,종로구 이화동,20241,20829,9849,10980
3869,종로구 이화동,20242,20936,9783,11153
3870,종로구 종로1.2.3.4가동,20221,21668,12823,8845
3871,종로구 종로1.2.3.4가동,20222,21655,12819,8836
3872,종로구 종로1.2.3.4가동,20223,21163,12630,8533
3873,종로구 종로1.2.3.4가동,20224,20213,12268,7945
3874,종로구 종로1.2.3.4가동,20231,20232,12312,7920
3875,종로구 종로1.2.3.4가동,20232,20159,12266,7893
3876,종로구 종로1.2.3.4가동,20233,20161,12270,7891
3877,종로구 종로1.2.3.4가동,20234,20076,12177,7899
3878,종로구 종로1.2.3.4가동,20241,20050,12083,7967
3879,종로구 종로1.2.3.4가동,20242,20138,12126,8012
3880,종로구 종로5.6가동,20221,15224,8101,7123
3881,종로구 종로5.6가동,20222,15210,8073,7137
3882,종로구 종로5.6가동,20223,15233,8093,7140
3883,종로구 종로5.6가동,20224,15822,8361,7461
3884,종로구 종로5.6가동,20231,16106,8471,7635
3885,종로구 종로5.6가동,20232,16282,8588,7694
3886,종로구 종로5.6가동,20233,16272,8585,7687
3887,종로구 종로5.6가동,20234,16169,8514,7655
3888,종로구 종로5.6가동,20241,16061,8441,7620
3889,종로구 종로5.6가동,20242,16015,8414,7601
3890,종로구 창신1동,20221,14718,7912,6806
3891,종로구 창신1동,20222,14623,7841,6782
3892,종로구 창신1동,20223,14407,7697,6710
3893,종로구 창신1동,20224,13979,7428,6551
3894,종로구 창신1동,20231,13899,7377,6522
3895,종로구 창신1동,20232,13832,7321,6511
3896,종로구 창신1동,20233,13720,7268,6452
3897,종로구 창신1동,20234,13573,7191,6382
3898,종로구 창신1동,20241,13504,7147,6357
3899,종로구 창신1동,20242,13483,7124,6359
3900,종로구 창신2동,20221,23644,12208,11436
3901,종로구 창신2동,20222,23549,12113,11436
3902,종로구 창신2동,20223,23398,12026,11372
3903,종로구 창신2동,20224,23149,11899,11250
3904,종로구 창신2동,20231,23019,11834,11185
3905,종로구 창신2동,20232,22801,11738,11063
3906,종로구 창신2동,20233,22609,11684,10925
3907,종로구 창신2동,20234,22565,11671,10894
3908,종로구 창신2동,20241,22438,11566,10872
3909,종로구 창신2동,20242,22338,11530,10808
3910,종로구 창신3동,20221,19621,9673,9948
3911,종로구 창신3동,20222,19509,9609,9900
3912,종로구 창신3동,20223,19460,9571,9889
3913,종로구 창신3동,20224,19364,9532,9832
3914,종로구 창신3동,20231,19343,9496,9847
3915,종로구 창신3동,20232,19255,9445,9810
3916,종로구 창신3동,20233,19137,9401,9736
3917,종로구 창신3동,20234,19080,9383,9697
3918,종로구 창신3동,20241,18989,9359,9630
3919,종로구 창신3동,20242,18946,9326,9620
3920,종로구 청운효자동,20221,35798,16507,19291
3921,종로구 청운효자동,20222,35494,16341,19153
3922,종로구 청운효자동,20223,35239,16149,19090
3923,종로구 청운효자동,20224,35005,16080,18925
3924,종로구 청운효자동,20231,34779,15953,18826
3925,종로구 청운효자동,20232,34559,15848,18711
3926,종로구 청운효자동,20233,34279,15681,18598
3927,종로구 청운효자동,20234,34053,15561,18492
3928,종로구 청운효자동,20241,33895,15455,18440
3929,종로구 청운효자동,20242,33659,15328,18331
3930,종로구 평창동,20221,54353,25333,29020
3931,종로구 평창동,20222,54049,25163,28886
3932,종로구 평창동,20223,53655,24994,28661
3933,종로구 평창동,20224,53051,24736,28315
3934,종로구 평창동,20231,52791,24637,28154
3935,종로구 평창동,20232,52460,24466,27994
3936,종로구 평창동,20233,52372,24377,27995
3937,종로구 평창동,20234,52196,24307,27889
3938,종로구 평창동,20241,51975,24145,27830
3939,종로구 평창동,20242,51805,24014,27791
3940,종로구 혜화동,20221,49135,23645,25490
3941,종로구 혜화동,20222,49061,23573,25488
3942,종로구 혜화동,20223,49029,23575,25454
3943,종로구 혜화동,20224,48566,23338,25228
3944,종로구 혜화동,20231,48397,23263,25134
3945,종로구 혜화동,20232,48235,23116,25119
3946,종로구 혜화동,20233,48042,23080,24962
3947,종로구 혜화동,20234,47691,22904,24787
3948,종로구 혜화동,20241,47823,23038,24785
3949,종로구 혜화동,20242,47876,23095,24781
3950,중구 광희동,20221,15727,8005,7722
3951,중구 광희동,20222,15802,7987,7815
3952,중구 광희동,20223,15924,8049,7875
3953,중구 광희동,20224,15614,7862,7752
3954,중구 광희동,20231,16203,8135,8068
3955,중구 광희동,20232,16976,8449,8527
3956,중구 광희동,20233,17165,8484,8681
3957,중구 광희동,20234,17316,8498,8818
3958,중구 광희동,20241,17474,8602,8872
3959,중구 광희동,20242,17426,8561,8865
3960,중구 다산동,20221,41268,20051,21217
3961,중구 다산동,20222,41190,19991,21199
3962,중구 다산동,20223,40958,19852,21106
3963,중구 다산동,20224,40437,19573,20864
3964,중구 다산동,20231,40404,19545,20859
3965,중구 다산동,20232,40232,19455,20777
3966,중구 다산동,20233,40110,19450,20660
3967,중구 다산동,20234,39905,19354,20551
3968,중구 다산동,20241,39740,19276,20464
3969,중구 다산동,20242,39568,19159,20409
3970,중구 동화동,20221,30652,14780,15872
3971,중구 동화동,20222,30520,14678,15842
3972,중구 동화동,20223,30391,14604,15787
3973,중구 동화동,20224,30116,14465,15651
3974,중구 동화동,20231,30088,14425,15663
3975,중구 동화동,20232,30007,14426,15581
3976,중구 동화동,20233,29948,14413,15535
3977,중구 동화동,20234,29821,14378,15443
3978,중구 동화동,20241,29836,14356,15480
3979,중구 동화동,20242,29803,14295,15508
3980,중구 명동,20221,8597,3749,4848
3981,중구 명동,20222,8634,3768,4866
3982,중구 명동,20223,8603,3771,4832
3983,중구 명동,20224,8320,3632,4688
3984,중구 명동,20231,8163,3514,4649
3985,중구 명동,20232,8091,3440,4651
3986,중구 명동,20233,8014,3394,4620
3987,중구 명동,20234,7818,3260,4558
3988,중구 명동,20241,7807,3238,4569
3989,중구 명동,20242,7795,3243,4552
3990,중구 소공동,20221,6745,3228,3517
3991,중구 소공동,20222,6761,3244,3517
3992,중구 소공동,20223,6705,3238,3467
3993,중구 소공동,20224,6733,3250,3483
3994,중구 소공동,20231,6656,3169,3487
3995,중구 소공동,20232,6632,3138,3494
3996,중구 소공동,20233,6595,3103,3492
3997,중구 소공동,20234,6545,3094,3451
3998,중구 소공동,20241,6578,3106,3472
3999,중구 소공동,20242,6565,3096,3469
4000,중구 신당5동,20221,30968,15080,15888
4001,중구 신당5동,20222,30854,14998,15856
4002,중구 신당5동,20223,30724,14886,15838
4003,중구 신당5동,20224,30522,14803,15719
4004,중구 신당5동,20231,30437,14749,15688
4005,중구 신당5동,20232,30388,14689,15699
4006,중구 신당5동,20233,30363,14641,15722
4007,중구 신당5동,20234,30414,14715,15699
4008,중구 신당5동,20241,30439,14735,15704
4009,중구 신당5동,20242,30508,14767,15741
4010,중구 신당동,20221,23045,11332,11713
4011,중구 신당동,20222,23181,11390,11791
4012,중구 신당동,20223,23162,11361,11801
4013,중구 신당동,20224,22880,11248,11632
4014,중구 신당동,20231,22790,11215,11575
4015,중구 신당동,20232,22584,11132,11452
4016,중구 신당동,20233,22372,11027,11345
4017,중구 신당동,20234,22269,10912,11357
4018,중구 신당동,20241,22257,10865,11392
4019,중구 신당동,20242,22259,10860,11399
4020,중구 약수동,20221,49958,23163,26795
4021,중구 약수동,20222,49727,23016,26711
4022,중구 약수동,20223,49363,22868,26495
4023,중구 약수동,20224,49226,22787,26439
4024,중구 약수동,20231,49040,22651,26389
4025,중구 약수동,20232,48900,22558,26342
4026,중구 약수동,20233,48682,22449,26233
4027,중구 약수동,20234,48436,22320,26116
4028,중구 약수동,20241,48305,22302,26003
4029,중구 약수동,20242,48315,22271,26044
4030,중구 을지로동,20221,5242,3174,2068
4031,중구 을지로동,20222,5201,3161,2040
4032,중구 을지로동,20223,5125,3130,1995
4033,중구 을지로동,20224,4963,3043,1920
4034,중구 을지로동,20231,5337,3219,2118
4035,중구 을지로동,20232,7472,4264,3208
4036,중구 을지로동,20233,8530,4776,3754
4037,중구 을지로동,20234,9005,4980,4025
4038,중구 을지로동,20241,9217,5054,4163
4039,중구 을지로동,20242,9352,5095,4257
4040,중구 장충동,20221,13755,7103,6652
4041,중구 장충동,20222,13849,7219,6630
4042,중구 장충동,20223,13967,7331,6636
4043,중구 장충동,20224,13756,7243,6513
4044,중구 장충동,20231,13723,7248,6475
4045,중구 장충동,20232,13783,7253,6530
4046,중구 장충동,20233,13746,7219,6527
4047,중구 장충동,20234,13720,7176,6544
4048,중구 장충동,20241,13661,7130,6531
4049,중구 장충동,20242,13691,7131,6560
4050,중구 중림동,20221,35897,17850,18047
4051,중구 중림동,20222,35952,17915,18037
4052,중구 중림동,20223,36048,17905,18143
4053,중구 중림동,20224,36072,17922,18150
4054,중구 중림동,20231,35967,17849,18118
4055,중구 중림동,20232,35857,17712,18145
4056,중구 중림동,20233,35916,17700,18216
4057,중구 중림동,20234,36381,17818,18563
4058,중구 중림동,20241,36588,17926,18662
4059,중구 중림동,20242,36450,17804,18646
4060,중구 청구동,20221,40641,19288,21353
4061,중구 청구동,20222,40359,19178,21181
4062,중구 청구동,20223,40154,19050,21104
4063,중구 청구동,20224,39677,18812,20865
4064,중구 청구동,20231,39457,18659,20798
4065,중구 청구동,20232,39349,18588,20761
4066,중구 청구동,20233,39245,18517,20728
4067,중구 청구동,20234,38991,18382,20609
4068,중구 청구동,20241,38924,18345,20579
4069,중구 청구동,20242,38675,18197,20478
4070,중구 필동,20221,12088,6192,5896
4071,중구 필동,20222,12082,6223,5859
4072,중구 필동,20223,12056,6224,5832
4073,중구 필동,20224,11943,6219,5724
4074,중구 필동,20231,11857,6156,5701
4075,중구 필동,20232,11892,6165,5727
4076,중구 필동,20233,12027,6264,5763
4077,중구 필동,20234,12021,6251,5770
4078,중구 필동,20241,12287,6344,5943
4079,중구 필동,20242,12878,6620,6258
4080,중구 황학동,20221,37800,18001,19799
4081,중구 황학동,20222,37912,18029,19883
4082,중구 황학동,20223,37875,17966,19909
4083,중구 황학동,20224,37751,17921,19830
4084,중구 황학동,20231,38191,18148,20043
4085,중구 황학동,20232,38446,18242,20204
4086,중구 황학동,20233,38300,18119,20181
4087,중구 황학동,20234,38043,17967,20076
4088,중구 황학동,20241,38118,17946,20172
4089,중구 황학동,20242,38278,18025,20253
4090,중구 회현동,20221,14272,7408,6864
4091,중구 회현동,20222,14205,7352,6853
4092,중구 회현동,20223,14012,7246,6766
4093,중구 회현동,20224,13620,7036,6584
4094,중구 회현동,20231,13522,7017,6505
4095,중구 회현동,20232,13428,6997,6431
4096,중구 회현동,20233,13334,6971,6363
4097,중구 회현동,20234,13157,6905,6252
4098,중구 회현동,20241,13112,6904,6208
4099,중구 회현동,20242,13050,6868,6182
4100,중랑구 망우3동,20221,48815,24531,24284
4101,중랑구 망우3동,20222,48506,24451,24055
4102,중랑구 망우3동,20223,48245,24360,23885
4103,중랑구 망우3동,20224,47838,24131,23707
4104,중랑구 망우3동,20231,47744,24032,23712
4105,중랑구 망우3동,20232,47565,23887,23678
4106,중랑구 망우3동,20233,47359,23785,23574
4107,중랑구 망우3동,20234,47121,23716,23405
4108,중랑구 망우3동,20241,46917,23595,23322
4109,중랑구 망우3동,20242,46748,23470,23278
4110,중랑구 망우본동,20221,101933,50857,51076
4111,중랑구 망우본동,20222,106584,52848,53736
4112,중랑구 망우본동,20223,106782,52814,53968
4113,중랑구 망우본동,20224,106481,52662,53819
4114,중랑구 망우본동,20231,106732,52776,53956
4115,중랑구 망우본동,20232,106785,52732,54053
4116,중랑구 망우본동,20233,106621,52611,54010
4117,중랑구 망우본동,20234,107496,53067,54429
4118,중랑구 망우본동,20241,111875,55142,56733
4119,중랑구 망우본동,20242,113590,55983,57607
4120,중랑구 면목2동,20221,72202,36027,36175
4121,중랑구 면목2동,20222,72148,36017,36131
4122,중랑구 면목2동,20223,72222,35974,36248
4123,중랑구 면목2동,20224,71674,35698,35976
4124,중랑구 면목2동,20231,71473,35590,35883
4125,중랑구 면목2동,20232,71327,35513,35814
4126,중랑구 면목2동,20233,71079,35393,35686
4127,중랑구 면목2동,20234,70936,35216,35720
4128,중랑구 면목2동,20241,70549,34965,35584
4129,중랑구 면목2동,20242,70325,34836,35489
4130,중랑구 면목3.8동,20221,73948,36667,37281
4131,중랑구 면목3.8동,20222,73507,36468,37039
4132,중랑구 면목3.8동,20223,73231,36335,36896
4133,중랑구 면목3.8동,20224,72703,36032,36671
4134,중랑구 면목3.8동,20231,73162,36248,36914
4135,중랑구 면목3.8동,20232,73953,36634,37319
4136,중랑구 면목3.8동,20233,73683,36425,37258
4137,중랑구 면목3.8동,20234,73343,36180,37163
4138,중랑구 면목3.8동,20241,73038,35955,37083
4139,중랑구 면목3.8동,20242,72591,35671,36920
4140,중랑구 면목4동,20221,56915,28325,28590
4141,중랑구 면목4동,20222,56589,28176,28413
4142,중랑구 면목4동,20223,56035,27890,28145
4143,중랑구 면목4동,20224,55520,27647,27873
4144,중랑구 면목4동,20231,55214,27433,27781
4145,중랑구 면목4동,20232,55072,27404,27668
4146,중랑구 면목4동,20233,54820,27275,27545
4147,중랑구 면목4동,20234,54590,27193,27397
4148,중랑구 면목4동,20241,54341,27060,27281
4149,중랑구 면목4동,20242,54130,26943,27187
4150,중랑구 면목5동,20221,44483,22374,22109
4151,중랑구 면목5동,20222,44474,22346,22128
4152,중랑구 면목5동,20223,44253,22204,22049
4153,중랑구 면목5동,20224,44136,22130,22006
4154,중랑구 면목5동,20231,44026,22048,21978
4155,중랑구 면목5동,20232,44013,22012,22001
4156,중랑구 면목5동,20233,43846,21865,21981
4157,중랑구 면목5동,20234,43788,21811,21977
4158,중랑구 면목5동,20241,43580,21704,21876
4159,중랑구 면목5동,20242,43415,21621,21794
4160,중랑구 면목7동,20221,65245,32756,32489
4161,중랑구 면목7동,20222,64958,32566,32392
4162,중랑구 면목7동,20223,64594,32362,32232
4163,중랑구 면목7동,20224,64414,32229,32185
4164,중랑구 면목7동,20231,64426,32190,32236
4165,중랑구 면목7동,20232,64255,32077,32178
4166,중랑구 면목7동,20233,64000,31884,32116
4167,중랑구 면목7동,20234,63677,31708,31969
4168,중랑구 면목7동,20241,63572,31630,31942
4169,중랑구 면목7동,20242,63397,31515,31882
4170,중랑구 면목본동,20221,100297,49691,50606
4171,중랑구 면목본동,20222,100187,49592,50595
4172,중랑구 면목본동,20223,99990,49391,50599
4173,중랑구 면목본동,20224,99621,49223,50398
4174,중랑구 면목본동,20231,99294,49027,50267
4175,중랑구 면목본동,20232,98838,48755,50083
4176,중랑구 면목본동,20233,98772,48787,49985
4177,중랑구 면목본동,20234,98466,48532,49934
4178,중랑구 면목본동,20241,98236,48361,49875
4179,중랑구 면목본동,20242,97944,48209,49735
4180,중랑구 묵1동,20221,103367,49826,53541
4181,중랑구 묵1동,20222,103164,49593,53571
4182,중랑구 묵1동,20223,103039,49411,53628
4183,중랑구 묵1동,20224,102497,49070,53427
4184,중랑구 묵1동,20231,102155,48743,53412
4185,중랑구 묵1동,20232,101784,48606,53178
4186,중랑구 묵1동,20233,101278,48342,52936
4187,중랑구 묵1동,20234,101184,48253,52931
4188,중랑구 묵1동,20241,100834,48002,52832
4189,중랑구 묵1동,20242,100435,47759,52676
4190,중랑구 묵2동,20221,55967,27456,28511
4191,중랑구 묵2동,20222,55734,27357,28377
4192,중랑구 묵2동,20223,55418,27182,28236
4193,중랑구 묵2동,20224,55166,27040,28126
4194,중랑구 묵2동,20231,55143,26998,28145
4195,중랑구 묵2동,20232,55042,26891,28151
4196,중랑구 묵2동,20233,54795,26725,28070
4197,중랑구 묵2동,20234,54350,26512,27838
4198,중랑구 묵2동,20241,54236,26500,27736
4199,중랑구 묵2동,20242,54035,26439,27596
4200,중랑구 상봉1동,20221,71860,34969,36891
4201,중랑구 상봉1동,20222,71437,34742,36695
4202,중랑구 상봉1동,20223,71090,34526,36564
4203,중랑구 상봉1동,20224,70727,34300,36427
4204,중랑구 상봉1동,20231,70348,34149,36199
4205,중랑구 상봉1동,20232,70121,34064,36057
4206,중랑구 상봉1동,20233,69970,34023,35947
4207,중랑구 상봉1동,20234,69648,33839,35809
4208,중랑구 상봉1동,20241,69295,33635,35660
4209,중랑구 상봉1동,20242,68827,33387,35440
4210,중랑구 상봉2동,20221,60775,29340,31435
4211,중랑구 상봉2동,20222,60780,29348,31432
4212,중랑구 상봉2동,20223,60575,29158,31417
4213,중랑구 상봉2동,20224,60681,29166,31515
4214,중랑구 상봉2동,20231,60754,29186,31568
4215,중랑구 상봉2동,20232,60683,29129,31554
4216,중랑구 상봉2동,20233,60619,29021,31598
4217,중랑구 상봉2동,20234,60951,29048,31903
4218,중랑구 상봉2동,20241,61229,29045,32184
4219,중랑구 상봉2동,20242,61463,29064,32399
4220,중랑구 신내1동,20221,115393,55881,59512
4221,중랑구 신내1동,20222,114874,55564,59310
4222,중랑구 신내1동,20223,114725,55413,59312
4223,중랑구 신내1동,20224,114170,55147,59023
4224,중랑구 신내1동,20231,114493,55262,59231
4225,중랑구 신내1동,20232,114972,55513,59459
4226,중랑구 신내1동,20233,114443,55181,59262
4227,중랑구 신내1동,20234,113725,54783,58942
4228,중랑구 신내1동,20241,112815,54280,58535
4229,중랑구 신내1동,20242,112256,53991,58265
4230,중랑구 신내2동,20221,60837,28965,31872
4231,중랑구 신내2동,20222,60575,28851,31724
4232,중랑구 신내2동,20223,60390,28748,31642
4233,중랑구 신내2동,20224,60225,28619,31606
4234,중랑구 신내2동,20231,59917,28470,31447
4235,중랑구 신내2동,20232,59655,28307,31348
4236,중랑구 신내2동,20233,59477,28189,31288
4237,중랑구 신내2동,20234,59270,28012,31258
4238,중랑구 신내2동,20241,58801,27764,31037
4239,중랑구 신내2동,20242,58511,27576,30935
4240,중랑구 중화1동,20221,58633,28757,29876
4241,중랑구 중화1동,20222,58291,28640,29651
4242,중랑구 중화1동,20223,57914,28504,29410
4243,중랑구 중화1동,20224,57528,28296,29232
4244,중랑구 중화1동,20231,57205,28170,29035
4245,중랑구 중화1동,20232,56958,27995,28963
4246,중랑구 중화1동,20233,56718,27924,28794
4247,중랑구 중화1동,20234,56271,27720,28551
4248,중랑구 중화1동,20241,55984,27653,28331
4249,중랑구 중화1동,20242,55647,27555,28092
4250,중랑구 중화2동,20221,74577,38316,36261
4251,중랑구 중화2동,20222,74378,38190,36188
4252,중랑구 중화2동,20223,74034,37967,36067
4253,중랑구 중화2동,20224,73551,37763,35788
4254,중랑구 중화2동,20231,73143,37537,35606
4255,중랑구 중화2동,20232,72766,37343,35423
4256,중랑구 중화2동,20233,72076,36951,35125
4257,중랑구 중화2동,20234,71587,36662,34925
4258,중랑구 중화2동,20241,71270,36522,34748
4259,중랑구 중화2동,20242,70978,36293,34685
